LGA_MAIN11,P_85ov_DNPCC,P_85ov_UCC_NS,P_85ov_Total,P_Tot_CF_Own_CCO,P_Tot_CF_Oth_CCO,P_Tot_CF_Own_CC_Oth_CC,P_Tot_CF_Total,P_Tot_DNPCC,P_Tot_UCC_NS,P_Tot_Total,LGA_NAME11
19499,69,52,121,1112,551,45,1708,7209,2821,11738,
29499,39,15,54,831,371,24,1226,4418,1624,7268,
14300,68,27,95,817,318,34,1169,2475,1102,4746,Junee (A)
14350,614,103,717,3649,1511,201,5361,15021,2281,22663,Kempsey (A)
14400,521,90,615,2955,1585,241,4781,10797,899,16477,Kiama (A)
14450,1050,177,1241,9303,2804,203,12310,30773,2875,45958,Kogarah (C)
14500,2848,583,3482,19889,6736,795,27420,54900,4461,86781,Ku-ring-gai (A)
14550,166,33,205,1282,591,74,1947,4976,546,7469,Kyogle (A)
14600,138,20,158,994,416,46,1456,3210,431,5097,Lachlan (A)
31820,1428,433,1868,13168,4647,657,18472,47845,6066,72383,Bundaberg (R)
13050,112,27,142,642,278,22,942,2878,275,4095,Gloucester (A)
13100,3899,1194,5129,25570,10794,1490,37854,83573,10636,132063,Gosford (C)
41560,283,53,339,1760,845,96,2701,7368,679,10748,Copper Coast (DC)
41750,15,0,15,181,53,3,237,570,37,844,Elliston (DC)
12850,2084,366,2487,26601,8408,510,35519,102571,11456,149546,Fairfield (C)
12900,184,43,230,1342,533,47,1922,4771,545,7238,Forbes (A)
12950,83,31,114,636,253,27,916,2259,321,3496,Gilgandra (A)
14650,3986,788,4816,30114,15025,1575,46714,97546,9570,153830,Lake Macquarie (C)
14700,635,118,764,5737,1616,229,7582,16616,1339,25537,Lane Cove (A)
14750,141,45,190,1665,670,77,2412,5116,896,8424,Leeton (A)
14800,471,154,630,8883,2450,401,11734,28556,3121,43411,Leichhardt (A)
14850,752,104,865,6610,2754,471,9835,22341,2175,34351,Lismore (C)
14870,308,73,384,2936,1265,171,4372,10366,1648,16386,Lithgow (C)
14900,1247,296,1557,30413,8001,824,39238,86317,12341,137896,Liverpool (C)
14920,147,22,169,1039,384,47,1470,4087,465,6022,Liverpool Plains (A)
14950,78,13,91,455,222,18,695,1513,159,2367,Lockhart (A)
15050,882,160,1054,12253,4822,631,17706,31569,3378,52653,Maitland (C)
15150,673,173,859,7000,2224,311,9535,20139,2557,32231,Manly (A)
15200,731,162,903,10815,3426,521,14762,44704,5799,65265,Marrickville (A)
15270,371,90,461,3467,1151,154,4772,11502,1519,17793,Mid-Western Regional (A)
15300,143,23,166,2095,721,149,2965,6131,1187,10283,Moree Plains (A)
15350,688,135,837,4557,1494,181,6232,14274,1926,22432,Mosman (A)
15500,123,26,149,978,426,48,1452,3864,454,5770,Murray (A)
15550,24,3,27,367,127,18,512,1085,151,1748,Murrumbidgee (A)
15650,139,32,171,2789,950,122,3861,7002,1327,12190,Muswellbrook (A)
15700,517,110,627,2360,1033,132,3525,10590,1215,15330,Nambucca (A)
15750,198,31,229,2050,736,117,2903,6281,871,10055,Narrabri (A)
15800,133,25,161,825,417,44,1286,2927,449,4662,Narrandera (A)
15850,73,20,96,973,422,62,1457,3126,429,5012,Narromine (A)
15900,3151,671,3865,22384,10285,1320,33989,80718,8518,123225,Newcastle (C)
15950,832,223,1074,7401,3131,234,10766,39236,5352,55354,North Sydney (A)
16100,68,10,78,802,319,27,1148,2509,366,4023,Oberon (A)
16150,662,104,770,6293,2412,342,9047,18284,2301,29632,Orange (C)
16180,88,15,106,2545,828,114,3487,6974,798,11259,Palerang (A)
16200,300,63,370,2248,857,138,3243,6983,1091,11317,Parkes (A)
16250,2362,652,3050,26799,7347,726,34872,88573,11857,135302,Parramatta (C)
16350,1448,423,1894,30829,11523,1477,43829,85705,10222,139756,Penrith (C)
16370,1221,277,1518,10404,4011,555,14970,27890,2867,45727,Pittwater (A)
16380,1933,501,2455,10428,4247,616,15291,39999,4465,59755,Port Macquarie-Hastings (A)
16400,1059,313,1379,10012,4447,584,15043,33008,4125,52176,Port Stephens (A)
16470,334,102,442,6578,2211,284,9073,19103,2122,30298,Queanbeyan (C)
16550,2317,432,2777,18349,6039,710,25098,73132,11259,109489,Randwick (C)
16610,439,124,567,3231,1300,169,4700,11286,1460,17446,Richmond Valley (A)
16650,2085,364,2476,14681,4769,346,19796,53598,7018,80412,Rockdale (C)
16700,2056,408,2499,16588,4893,554,22035,58474,5413,85922,Ryde (C)
16900,788,120,919,10999,4733,600,16332,30649,3063,50044,Shellharbour (C)
16950,2023,526,2566,12762,5534,682,18978,50405,7027,76410,Shoalhaven (C)
17000,235,30,268,4187,1417,210,5814,10675,1176,17665,Singleton (A)
17050,57,7,70,1184,318,61,1563,3623,834,6020,Snowy River (A)
17750,929,190,1130,9582,3597,486,13665,30338,2882,46885,Wagga Wagga (C)
17800,80,19,99,529,235,22,786,2150,326,3262,Wakool (A)
17850,69,8,77,451,141,19,611,1706,143,2460,Walcha (A)
17900,56,17,76,813,310,47,1170,3247,665,5082,Walgett (A)
17950,41,6,47,398,168,18,584,1436,162,2182,Warren (A)
18000,3251,588,3877,26055,8562,1199,35816,70027,6588,112431,Warringah (A)
18020,225,40,268,1345,510,78,1933,4991,728,7652,Warrumbungle Shire (A)
18050,1068,300,1386,9000,2988,409,12397,34301,6992,53690,Waverley (A)
18100,82,16,98,509,221,19,749,1996,233,2978,Weddin (A)
18150,135,14,158,1182,495,40,1717,3999,1032,6748,Wellington (A)
18200,67,39,106,1001,420,50,1471,3322,479,5272,Wentworth (A)
18250,1312,177,1510,12412,3014,467,15893,35265,3339,54497,Willoughby (C)
18350,934,228,1168,6936,2845,351,10132,23184,2470,35786,Wingecarribee (A)
18400,387,73,466,7900,2725,377,11002,20182,2092,33276,Wollondilly (A)
18450,3550,681,4265,30291,13909,1668,45868,100107,10771,156746,Wollongong (C)
18500,1167,354,1544,7264,3106,205,10575,28161,5369,44105,Woollahra (A)
18550,2946,857,3834,23969,9779,1286,35034,74882,9505,119421,Wyong (A)
18710,155,63,221,2711,986,143,3840,7067,796,11703,Yass Valley (A)
18750,267,57,324,1966,697,96,2759,5953,818,9530,Young (A)
19399,14,0,14,195,42,3,240,681,57,978,Unincorporated NSW
20110,257,52,309,1698,619,101,2418,6751,685,9854,Alpine (S)
20260,193,77,270,1584,684,80,2348,5778,1082,9208,Ararat (RC)
20570,1485,506,2012,14950,6337,847,22134,47581,5623,75338,Ballarat (C)
20660,2399,479,2907,19132,7589,905,27626,63937,5668,97231,Banyule (C)
20740,586,242,840,4256,1874,226,6356,15938,2274,24568,Bass Coast (S)
20830,632,210,849,7005,2776,367,10148,21712,2425,34285,Baw Baw (S)
20910,2718,537,3307,16272,5723,814,22809,46144,4864,73817,Bayside (C)
21010,354,64,418,1843,842,99,2784,7765,721,11270,Benalla (RC)
21110,3828,745,4630,25900,8796,1077,35773,88135,7508,131416,Boroondara (C)
21180,1716,447,2183,26977,8750,530,36257,97785,13890,147932,Brimbank (C)
21270,205,37,245,890,375,47,1312,3555,354,5221,Buloke (S)
21370,709,194,908,5685,2336,242,8263,18508,2352,29123,Campaspe (S)
21450,721,121,847,14266,4126,743,19135,34114,3596,56845,Cardinia (S)
21610,2074,418,2513,47244,12484,1704,61432,119981,12373,193786,Casey (C)
21670,317,74,398,1620,693,75,2388,7150,883,10421,Central Goldfields (S)
21750,432,109,544,3143,1326,168,4637,10645,1211,16493,Colac-Otway (S)
21830,328,78,406,2664,899,151,3714,8265,1000,12979,Corangamite (S)
21890,2430,623,3079,20097,6444,894,27435,77145,9648,114228,Darebin (C)
41960,13,10,23,184,87,19,290,639,103,1032,Franklin Harbour (DC)
17650,63,22,88,1002,376,39,1417,3021,324,4762,Uralla (A)
17700,17,7,27,167,58,8,233,603,79,915,Urana (A)
22110,895,208,1110,5670,2382,373,8425,23796,2709,34930,East Gippsland (S)
22170,1677,602,2291,20783,7839,1127,29749,64572,7824,102145,Frankston (C)
22250,278,66,344,1464,648,72,2184,5572,730,8486,Gannawarra (S)
42110,101,18,119,608,253,32,893,2273,221,3387,Goyder (DC)
42250,42,42,84,1468,529,57,2054,3588,559,6201,Grant (DC)
22670,2058,360,2437,19104,5846,369,25319,75921,9741,110981,Greater Dandenong (C)
22750,4335,879,5255,33136,14118,1827,49081,110582,12261,171924,Greater Geelong (C)
22830,1017,232,1263,9607,3385,430,13422,29960,4117,47499,Greater Shepparton (C)
22910,262,64,326,2061,867,122,3050,7877,981,11908,Hepburn (S)
22980,248,28,276,810,321,36,1167,3275,326,4768,Hindmarsh (S)
23110,1259,334,1613,13527,4264,527,18318,44907,5433,68658,Hobsons Bay (C)
23190,342,152,500,3077,1225,163,4465,9912,1140,15517,Horsham (RC)
23270,896,246,1159,28133,7841,838,36812,82366,10300,129478,Hume (C)
23350,280,44,327,2450,978,138,3566,7831,910,12307,Indigo (S)
23430,2908,597,3552,23353,8013,998,32364,76983,7977,117324,Kingston (C)
23670,2089,418,2533,25011,8957,1190,35158,80472,6025,121655,Knox (C)
23810,1152,240,1402,11096,4701,587,16384,37213,4700,58297,Latrobe (C)
23940,185,39,227,959,437,47,1443,4201,521,6165,Loddon (S)
24130,541,80,628,7585,2555,447,10587,20482,1897,32966,Macedon Ranges (S)
24210,2001,537,2562,17460,7789,573,25822,62406,4803,93031,Manningham (C)
24250,131,24,164,1091,465,55,1611,4383,434,6428,Mansfield (S)
24330,932,201,1147,10795,2842,415,14052,39614,6102,59768,Maribyrnong (C)
24410,1909,453,2378,17630,6475,962,25067,54801,4479,84347,Maroondah (C)
24600,631,158,795,6378,3224,207,9809,66430,10743,86982,Melbourne (C)
24650,555,90,655,21844,5245,682,27771,48022,6466,82259,Melton (S)
24780,934,179,1118,7890,3038,388,11316,25470,3497,40283,Mildura (RC)
24850,343,70,416,6092,1937,293,8322,16519,2174,27015,Mitchell (S)
24900,619,173,799,4012,1639,209,5860,14777,2050,22687,Moira (S)
24970,3100,772,3920,25219,9725,781,35725,98542,8669,142936,Monash (C)
25060,1947,521,2501,16315,5723,578,22616,59923,6652,89191,Moonee Valley (C)
25150,318,87,411,4893,1689,260,6842,13833,1537,22212,Moorabool (S)
25250,2766,758,3561,20699,6607,839,28145,84880,10361,123386,Moreland (C)
25340,3071,1101,4195,22706,9789,1272,33767,74853,9437,118057,Mornington Peninsula (S)
45680,785,170,961,13118,4698,728,18544,37770,4586,60900,Playford (C)
25430,282,196,484,2482,1142,201,3825,9251,1650,14726,Mount Alexander (S)
25490,245,83,331,2765,1021,141,3927,7717,896,12540,Moyne (S)
25620,210,52,262,1976,765,104,2845,7044,925,10814,Murrindindi (S)
25710,448,146,606,11211,3918,718,15847,29840,2079,47766,Nillumbik (S)
25810,282,59,341,1689,702,95,2486,6549,741,9776,Northern Grampians (S)
25900,807,366,1188,10370,4164,427,14961,58495,7869,81325,Port Phillip (C)
25990,114,22,136,905,383,59,1347,3633,545,5525,Pyrenees (S)
26080,127,26,153,354,236,24,614,1757,199,2570,Queenscliffe (B)
26170,567,103,670,4131,1824,220,6175,14396,1497,22068,South Gippsland (S)
26260,443,89,535,2462,954,148,3564,8879,875,13318,Southern Grampians (S)
26350,1708,419,2161,11496,4850,422,16768,57460,6739,80967,Stonnington (C)
26430,241,63,307,1184,598,53,1835,5518,653,8006,Strathbogie (S)
26490,405,72,483,4772,1679,280,6731,12279,1336,20346,Surf Coast (S)
26610,372,97,478,3062,1180,165,4407,10227,1586,16220,Swan Hill (RC)
26670,148,37,185,880,335,45,1260,3259,309,4828,Towong (S)
26700,537,211,748,4049,1757,237,6043,14181,1511,21735,Wangaratta (RC)
26730,568,222,802,5096,2271,284,7651,15938,2099,25688,Warrnambool (C)
26810,692,167,867,6157,2578,374,9109,21105,3361,33575,Wellington (S)
26890,105,17,122,673,222,37,932,2279,241,3452,West Wimmera (S)
26980,3233,994,4282,24310,8679,1153,34142,83240,7815,125197,Whitehorse (C)
27070,1113,424,1546,26552,7952,752,35256,78726,8679,122661,Whittlesea (C)
27170,447,89,540,6073,2282,355,8710,17370,1725,27805,Wodonga (RC)
27260,878,217,1106,31872,7692,998,40562,73385,9308,123255,Wyndham (C)
27350,736,161,903,8151,3457,377,11985,47532,5817,65334,Yarra (C)
27450,1503,442,1965,25222,9518,1498,36238,72616,6823,115677,Yarra Ranges (S)
27630,238,45,286,942,385,66,1393,3948,505,5846,Yarriambiack (S)
29399,0,0,0,78,24,6,108,514,90,712,Unincorporated Vic
30250,0,0,4,179,205,33,417,407,78,902,Aurukun (S)
30300,39,11,53,790,246,31,1067,2131,314,3512,Balonne (S)
30370,150,35,185,2681,697,113,3491,6741,826,11058,Banana (S)
30410,30,5,35,554,147,8,709,1590,216,2515,Barcaldine (R)
30450,4,0,4,51,9,0,60,214,16,290,Barcoo (S)
30760,25,7,32,354,100,10,464,1176,128,1768,Blackall Tambo (R)
36070,0,0,0,117,104,4,225,260,9,494,Pormpuraaw (S)
36150,13,0,13,152,56,12,220,511,49,780,Quilpie (S)
36250,2230,472,2718,23534,9023,1220,33777,70752,6327,110856,Redland (C)
36300,14,3,17,140,24,0,164,417,71,652,Richmond (S)
36360,1176,620,1809,17200,6261,947,24408,52924,9163,86495,Rockhampton (R)
36510,580,94,678,5839,2203,347,8389,18615,1931,28935,Scenic Rim (R)
36580,201,70,277,3394,1257,183,4834,10895,1334,17063,Somerset (R)
36630,471,126,606,4667,1572,270,6509,15923,1967,24399,South Burnett (R)
36660,653,151,807,5197,1802,259,7258,17722,1919,26899,Southern Downs (R)
36710,5611,1370,7030,49856,17570,2696,70122,161584,17127,248833,Sunshine Coast (R)
36810,521,230,757,6238,2351,380,8969,22090,3866,34925,Tablelands (R)
36910,2202,825,3045,24589,9024,1343,34956,74689,9042,118687,Toowoomba (R)
36950,17,0,17,460,146,24,630,1275,377,2282,Torres (S)
36960,9,0,9,797,384,64,1245,1308,153,2706,Torres Strait Island (R)
37010,1499,339,1854,28464,10070,1438,39972,85440,12220,137632,Townsville (C)
50280,152,36,188,2145,610,154,2909,5532,853,9294,Augusta-Margaret River (S)
50350,239,36,279,2220,861,126,3207,7818,822,11847,Bassendean (T)
51080,10,6,16,201,56,9,266,498,65,829,Broomehill-Tambellup (S)
53220,3,3,6,1771,564,165,2500,5335,2286,10121,East Pilbara (S)
53290,148,39,187,2283,697,117,3097,6382,1011,10490,Esperance (S)
53360,9,0,9,401,98,28,527,1210,181,1918,Exmouth (S)
53430,510,88,602,3610,1636,267,5513,15285,1840,22638,Fremantle (C)
53520,380,93,481,5954,2101,356,8411,17376,2518,28305,Geraldton-Greenough (C)
53570,39,14,53,670,249,35,954,2428,385,3767,Gingin (S)
53640,11,3,14,229,88,23,340,536,64,940,Gnowangerup (S)
34770,1047,223,1281,19493,6408,973,26874,54011,7952,88837,Mackay (R)
34800,6,3,9,168,40,11,219,552,121,892,McKinlay (S)
41140,170,42,212,1325,576,82,1983,4653,405,7041,Clare and Gilbert Valleys (DC)
47910,72,20,92,357,201,30,588,1425,113,2126,Tumby Bay (DC)
54410,31,3,34,178,63,6,247,603,68,918,Kellerberrin (S)
55110,1089,454,1551,10267,4245,591,15103,36388,5266,56757,Mandurah (C)
55180,120,32,155,1481,479,86,2046,4643,503,7192,Manjimup (S)
55250,8,0,8,154,81,10,245,638,240,1123,Meekatharra (S)
55320,2047,475,2541,14646,5980,789,21415,53325,4764,79504,Melville (C)
56620,0,0,3,151,216,41,408,533,95,1036,Ngaanyatjarraku (S)
55460,32,6,38,530,143,23,696,1702,178,2576,Merredin (S)
56020,3,0,3,107,28,6,141,333,80,554,Mullewa (S)
56090,363,99,470,5771,2491,397,8659,17510,3397,29566,Mundaring (S)
57350,26,3,29,161,38,0,199,595,44,838,Quairading (S)
57420,4,5,9,365,72,19,456,1047,141,1644,Ravensthorpe (S)
57490,962,251,1225,18970,6131,1075,26176,48050,6194,80420,Rockingham (C)
57560,15,3,18,3525,702,183,4410,9556,4229,18195,Roebourne (S)
56450,0,0,0,157,54,7,218,459,31,708,Narrogin (S)
65410,213,51,273,2119,811,92,3022,7403,720,11145,Waratah/Wynyard (M)
65610,24,11,35,759,211,27,997,2399,319,3715,West Coast (M)
65810,287,112,399,3579,1280,186,5045,11506,1033,17584,West Tamar (M)
69399,0,0,0,6,6,0,12,82,15,109,
69499,0,0,0,111,59,3,173,653,149,975,
56790,28,21,49,482,156,23,661,1696,237,2594,Northampton (S)
56860,3,0,3,28,9,3,40,124,13,177,Nungarin (S)
57700,109,19,128,3357,1079,165,4601,7937,1033,13571,Serpentine-Jarrahdale (S)
57770,9,0,9,129,35,10,174,491,48,713,Shark Bay (S)
57840,885,212,1107,5159,2203,303,7665,24446,2789,34900,South Perth (C)
57910,3254,917,4217,28953,11231,1211,41395,107470,13810,162675,Stirling (C)
57980,244,79,323,2312,1001,118,3431,10532,1204,15167,Subiaco (C)
58050,780,218,1004,19679,5785,876,26340,51067,6601,84008,Swan (C)
58190,4,0,4,85,27,3,115,153,27,295,Tammin (S)
58260,8,3,11,112,23,7,142,284,44,470,Three Springs (S)
73600,6,7,19,798,775,221,1794,1916,489,4199,Roper Gulf (S)
58510,764,334,1106,4077,1340,174,5591,19550,3029,28170,Victoria Park (T)
58610,40,13,53,291,101,11,403,960,101,1464,Wagin (S)
58680,3,0,3,91,23,3,117,203,27,347,Wandering (S)
58760,1106,328,1446,29892,7975,1388,39255,67465,8246,114966,Wanneroo (C)
58820,50,8,58,572,196,43,811,1849,189,2849,Waroona (S)
58890,12,0,12,171,44,9,224,420,39,683,West Arthur (S)
79399,3,0,3,1442,245,69,1756,3198,1407,6361,Unincorporated NT
79499,0,0,0,127,79,0,206,1256,263,1725,
89399,3989,774,4829,57813,21173,3053,82039,191726,16540,290305,Unincorporated ACT
89499,3,3,6,62,36,3,101,403,69,573,
59250,0,0,0,184,69,13,266,625,144,1035,Wiluna (S)
59320,3,0,3,85,17,7,109,174,21,304,Woodanilling (S)
59330,16,0,16,75,13,5,93,285,44,422,Wyalkatchem (S)
59340,14,3,17,1100,437,109,1646,3527,719,5892,Wyndham-East Kimberley (S)
59350,0,0,0,60,15,0,75,212,64,351,Yalgoo (S)
11250,357,132,492,2525,1128,109,3762,9668,1746,15176,Broken Hill (C)
13310,460,122,585,4216,1722,205,6143,13982,2140,22265,Goulburn Mulwaree (A)
13320,941,385,1335,4090,1847,234,6171,20256,2713,29140,Great Lakes (A)
13340,170,31,205,1595,641,89,2325,4829,584,7738,Greater Hume Shire (A)
13380,1040,202,1248,6367,2718,351,9436,25545,2879,37860,Greater Taree (C)
13450,360,111,482,3972,1383,140,5495,11520,1865,18880,Griffith (C)
13500,64,19,87,550,220,27,797,1835,246,2878,Gundagai (A)
13550,182,85,267,1904,676,95,2675,5928,908,9511,Gunnedah (A)
13650,78,13,91,661,249,25,935,2217,276,3428,Guyra (A)
13660,113,20,133,770,253,32,1055,2705,262,4022,Gwydir (A)
10050,893,162,1065,7479,2963,374,10816,24881,2813,38510,Albury (C)
10110,385,83,471,3323,1340,204,4867,13031,1606,19504,Armidale Dumaresq (A)
13700,73,16,89,520,180,24,724,1943,221,2888,Harden (A)
13800,724,129,866,11006,4100,529,15635,30069,3283,48987,Hawkesbury (C)
13850,57,6,63,438,151,15,604,1568,187,2359,Hay (A)
13950,1144,426,1585,16498,4799,380,21677,49966,6769,78412,Holroyd (C)
14000,3110,655,3815,28115,9153,1239,38507,82157,5735,126399,Hornsby (A)
14100,566,73,644,2140,829,86,3055,7039,599,10693,Hunters Hill (A)
14150,1801,301,2125,12778,4323,325,17426,43452,3983,64861,Hurstville (C)
14200,230,132,366,2432,940,145,3517,8079,1062,12658,Inverell (A)
14250,29,6,35,221,77,15,313,779,115,1207,Jerilderie (A)
10150,1005,211,1234,6114,1633,197,7944,24083,2974,35001,Ashfield (A)
10200,729,121,858,10877,2500,195,13572,38618,7051,59241,Auburn (C)
10250,1156,235,1400,5921,2404,331,8656,21441,2135,32232,Ballina (A)
10300,23,13,36,344,117,12,473,1137,207,1817,Balranald (A)
10350,3168,706,3922,27986,8719,732,37437,92823,12544,142804,Bankstown (C)
10470,564,78,648,6091,2524,351,8966,18758,2800,30524,Bathurst Regional (A)
10550,604,193,803,4448,1799,270,6517,17810,2032,26359,Bega Valley (A)
10600,273,44,320,1944,791,157,2892,6598,584,10074,Bellingen (A)
10650,153,97,256,1106,472,46,1624,4422,622,6668,Berrigan (A)
10750,2296,442,2771,54120,15175,1831,71126,141825,16688,229639,Blacktown (C)
10800,128,23,151,925,360,40,1325,2946,309,4580,Bland (A)
10850,86,13,99,1176,380,50,1606,3370,442,5418,Blayney (A)
10900,1215,322,1553,12560,5382,912,18854,38261,4029,61144,Blue Mountains (C)
10950,42,5,47,464,162,21,647,1326,244,2217,Bogan (A)
11000,69,21,90,357,136,10,503,1327,135,1965,Bombala (A)
11050,41,7,48,340,110,19,469,1339,125,1933,Boorowa (A)
11100,565,98,675,6281,1885,179,8345,21181,2684,32210,Botany Bay (C)
11150,14,3,20,405,122,23,550,1200,392,2142,Bourke (A)
11200,16,6,22,233,82,6,321,884,113,1318,Brewarrina (A)
13010,191,28,219,1164,475,65,1704,4710,677,7091,Glen Innes Severn (A)
11300,614,183,811,4496,1430,113,6039,19338,2269,27646,Burwood (A)
11350,469,93,571,4888,1639,382,6909,14937,1973,23819,Byron (A)
11400,205,34,245,2114,771,94,2979,6510,526,10015,Cabonne (A)
11450,666,92,766,11276,3461,511,15248,25346,2361,42955,Camden (A)
11500,920,429,1368,23517,8860,918,33295,71613,9043,113951,Campbelltown (C)
11520,1210,284,1506,12137,3838,354,16329,41657,5031,63017,Canada Bay (A)
11550,1707,494,2226,21829,6052,406,28287,71010,10700,109997,Canterbury (C)
11600,30,5,35,397,142,28,567,1337,127,2031,Carrathool (A)
11700,11,3,14,291,94,13,398,1035,147,1580,Central Darling (A)
11720,738,126,864,8476,3762,443,12681,23763,3538,39982,Cessnock (C)
11730,1034,205,1249,6911,3034,396,10341,26922,3179,40442,Clarence Valley (A)
11750,50,11,61,764,242,35,1041,2257,360,3658,Cobar (A)
11800,1291,409,1706,10495,3946,550,14991,36125,4190,55306,Coffs Harbour (C)
11860,5,3,8,293,91,10,394,690,85,1169,Conargo (A)
12000,81,21,102,662,274,32,968,1961,252,3181,Coolamon (A)
12050,216,32,251,1487,529,82,2098,5184,618,7900,Cooma-Monaro (A)
12150,57,12,72,539,187,18,744,2140,285,3169,Coonamble (A)
12200,170,28,198,1012,510,66,1588,3859,501,5948,Cootamundra (A)
12300,202,95,306,1628,644,90,2362,5884,740,8986,Corowa Shire (A)
12350,279,48,327,1685,670,96,2451,6433,953,9837,Cowra (A)
12500,162,50,215,1021,435,35,1491,3716,564,5771,Deniliquin (A)
12600,598,97,707,6414,2699,392,9505,18459,2127,30091,Dubbo (C)
12700,145,18,163,1247,583,73,1903,4424,433,6760,Dungog (A)
12750,922,199,1131,4477,2015,247,6739,20450,2670,29859,Eurobodalla (A)
17100,559,97,669,5152,1436,110,6698,19938,2807,29443,Strathfield (A)
17150,3763,790,4598,36445,15053,1676,53174,107806,9510,170490,Sutherland Shire (A)
17200,995,430,1442,12631,5619,412,18662,115917,22879,157458,Sydney (C)
17310,956,218,1186,8839,3583,443,12865,28012,3620,44497,Tamworth Regional (A)
17350,141,26,170,840,393,46,1279,3002,319,4600,Temora (A)
17400,126,28,154,854,372,47,1273,3746,493,5512,Tenterfield (A)
17420,1572,223,1835,31679,11000,1183,43862,83925,5792,133579,The Hills Shire (A)
17450,73,13,86,451,162,29,642,1774,321,2737,Tumbarumba (A)
17500,215,50,271,1707,640,79,2426,5653,648,8727,Tumut Shire (A)
17550,2252,633,2902,12421,4899,701,18021,45967,5957,69945,Tweed (A)
17620,241,43,287,2348,788,111,3247,6792,809,10848,Upper Hunter Shire (A)
17640,122,21,147,1047,429,49,1525,3939,419,5883,Upper Lachlan Shire (A)
22310,3276,737,4072,21806,6697,913,29416,70946,7009,107371,Glen Eira (C)
22410,370,54,433,3027,1121,132,4280,10468,1184,15932,Glenelg (S)
22490,129,18,150,3564,1139,191,4894,8743,789,14426,Golden Plains (S)
22620,1702,550,2267,16086,6704,916,23706,51311,5892,80909,Greater Bendigo (C)
30900,0,0,0,62,24,3,89,249,30,368,Boulia (S)
31000,14405,4095,18692,164069,57737,7871,229677,566149,60247,856073,Brisbane (C)
50420,1149,200,1361,8790,3346,413,12549,35083,3917,51549,Bayswater (C)
50490,540,130,670,4936,1697,179,6812,19548,3030,29390,Belmont (C)
50560,30,6,36,182,63,12,257,931,105,1293,Beverley (S)
50630,15,3,18,374,93,33,500,959,390,1849,Boddington (S)
50770,31,4,35,293,79,11,383,796,72,1251,Boyup Brook (S)
50840,55,9,64,694,236,36,966,2296,165,3427,Bridgetown-Greenbushes (S)
50910,31,6,37,142,51,3,196,483,68,747,Brookton (S)
50980,27,16,43,2285,770,196,3251,6522,1602,11375,Broome (S)
31750,0,0,0,66,24,3,93,189,34,316,Bulloo (S)
31900,315,56,377,2684,1029,127,3840,8844,1075,13759,Burdekin (S)
31950,0,0,0,65,27,0,92,240,99,431,Burke (S)
32070,1284,378,1683,25285,8090,1381,34756,75111,12449,122316,Cairns (R)
32250,7,0,7,228,102,7,337,987,296,1620,Carpentaria (S)
32260,393,76,472,4018,1409,193,5620,14643,1986,22249,Cassowary Coast (R)
32270,69,41,113,5587,1289,265,7141,12127,2382,21650,Central Highlands (R)
32310,177,30,207,1898,649,77,2624,5805,968,9397,Charters Towers (R)
51120,17,10,27,168,57,12,237,444,57,738,Bruce Rock (S)
51190,514,156,679,4491,1866,244,6601,16574,2671,25846,Bunbury (C)
51260,488,90,581,5345,1732,271,7348,14741,1694,23783,Busselton (S)
51310,633,95,740,4543,1484,273,6300,12440,1074,19814,Cambridge (T)
51330,1053,219,1285,12810,4824,514,18148,47915,4726,70789,Canning (C)
51400,43,10,56,3020,709,152,3881,6004,725,10610,Capel (S)
51470,3,3,6,91,36,3,130,265,43,438,Carnamah (S)
51540,36,11,47,811,275,40,1126,2670,684,4480,Carnarvon (S)
51610,3,0,6,224,65,10,299,550,65,914,Chapman Valley (S)
32330,0,0,0,202,135,50,387,382,14,783,Cherbourg (S)
32450,13,5,18,459,156,17,632,1515,416,2563,Cloncurry (S)
32500,15,4,19,465,159,29,653,1937,805,3395,Cook (S)
32600,0,3,3,57,6,0,63,127,43,233,Croydon (S)
37300,0,0,0,581,142,48,771,1345,337,2453,Weipa (T)
37310,413,102,518,5239,1669,267,7175,14643,2389,24207,Western Downs (R)
37340,274,69,346,4520,1396,265,6181,15961,3396,25538,Whitsunday (R)
32750,0,0,0,37,4,3,44,174,15,233,Diamantina (S)
32770,7,0,7,241,72,14,327,458,11,796,Doomadgee (S)
33100,3,0,3,137,34,6,177,474,80,731,Etheridge (S)
33200,13,6,19,278,105,15,398,870,146,1414,Flinders (S)
33220,1474,594,2072,13511,4718,696,18925,51202,6955,77082,Fraser Coast (R)
33360,353,60,417,10497,2978,559,14034,26488,4137,44659,Gladstone (R)
33430,6741,2492,9304,79431,26395,3602,109428,256593,36757,402778,Gold Coast (C)
33610,117,39,156,1849,508,77,2434,4859,795,8088,Goondiwindi (R)
33620,505,297,808,6925,2326,361,9612,23507,3249,36368,Gympie (R)
33800,271,37,314,1653,652,75,2380,6410,733,9523,Hinchinbrook (S)
33830,3,0,6,170,135,15,320,331,40,691,Hope Vale (S)
33960,1440,333,1802,29776,10365,1600,41741,75769,9562,127072,Ipswich (C)
33980,54,12,66,4669,830,241,5740,8975,2162,16877,Isaac (R)
34420,3,0,3,194,169,21,384,345,13,742,Kowanyama (S)
34570,0,0,0,78,95,21,194,152,9,355,Lockhart River (S)
34580,379,80,462,5412,1899,299,7610,17171,2448,27229,Lockyer Valley (R)
34590,1878,597,2504,48452,17082,2496,68030,129000,16389,213419,Logan (C)
34710,52,9,64,684,206,36,926,2010,221,3157,Longreach (R)
34830,6,0,6,55,14,0,69,126,8,203,Mapoon (S)
34860,132,22,157,2165,647,78,2890,6099,1117,10106,Maranoa (R)
35010,4270,1268,5578,66979,23367,3803,94149,180557,20374,295080,Moreton Bay (R)
35250,3,0,3,155,156,45,356,360,20,736,Mornington (S)
35300,56,10,69,3445,1007,191,4643,8832,2644,16119,Mount Isa (C)
35600,62,13,75,720,215,28,963,2258,374,3595,Murweh (S)
35670,0,0,0,134,126,38,298,261,9,568,Napranum (S)
35760,128,84,215,1452,516,70,2038,5216,906,8160,North Burnett (R)
35780,5,0,8,429,173,6,608,792,87,1487,Northern Peninsula Area (R)
35790,3,0,3,364,230,37,631,931,41,1603,Palm Island (S)
35800,18,4,22,238,96,14,348,951,142,1441,Paroo (S)
37400,18,3,21,185,54,9,248,734,99,1081,Winton (S)
37550,0,0,0,154,59,0,213,374,18,605,Woorabinda (S)
51960,4,5,9,722,159,37,918,1639,439,2996,Coolgardie (S)
52030,6,0,6,134,55,12,201,616,59,876,Coorow (S)
37570,0,0,0,51,39,0,90,125,0,215,Wujal Wujal (S)
37600,8,0,8,399,395,22,816,750,15,1581,Yarrabah (S)
39399,6,3,9,33,26,0,59,302,92,453,
39499,41,12,53,911,637,49,1597,7974,1912,11483,
40070,312,49,364,1248,847,46,2141,14202,2153,18496,Adelaide (C)
40120,465,94,569,6840,2810,456,10106,19435,1493,31034,Adelaide Hills (DC)
40220,494,76,579,3493,1753,184,5430,13132,1144,19706,Alexandrina (DC)
40250,9,0,13,371,329,104,804,909,91,1804,Anangu Pitjantjatjara (AC)
40310,469,80,552,3815,1516,209,5540,11314,904,17758,Barossa (DC)
40430,80,16,96,328,129,12,469,1469,133,2071,Barunga West (DC)
40520,185,76,264,1555,641,77,2273,5474,743,8490,Berri and Barmera (DC)
40700,1205,328,1557,6361,2889,315,9565,23851,2076,35492,Burnside (C)
40910,1121,186,1325,7354,3337,269,10960,27028,2129,40117,Campbelltown (C)
41010,36,7,43,500,233,36,769,1768,181,2718,Ceduna (DC)
41060,2594,693,3316,15128,6864,605,22597,59682,6057,88336,Charles Sturt (C)
41190,39,10,49,285,106,12,403,912,54,1369,Cleve (DC)
41330,7,0,7,175,61,14,250,954,210,1414,Coober Pedy (DC)
41830,40,6,46,230,94,10,334,938,114,1386,Flinders Ranges (DC)
42030,407,83,493,3172,1368,168,4708,10965,1122,16795,Gawler (T)
42600,1440,270,1724,4307,2549,221,7077,21074,2090,30241,Holdfast Bay (C)
42750,84,20,104,696,289,43,1028,2346,253,3627,Kangaroo Island (DC)
43080,18,3,21,154,59,6,219,557,63,839,Karoonda East Murray (DC)
43220,17,18,35,205,49,7,261,552,64,877,Kimba (DC)
43360,50,4,54,343,124,17,484,1313,125,1922,Kingston (DC)
43650,148,31,179,2569,856,164,3589,6537,545,10671,Light (RegC)
43710,43,11,54,875,327,48,1250,2300,285,3835,Lower Eyre Peninsula (DC)
43790,282,40,331,1696,688,106,2490,6086,561,9137,Loxton Waikerie (DC)
43920,66,6,72,1438,514,72,2024,4234,389,6647,Mallala (DC)
44000,0,0,0,9,15,3,27,27,3,57,Maralinga Tjarutja (AC)
44060,1968,435,2418,12430,5447,658,18535,46858,4132,69525,Marion (C)
44210,116,20,136,998,513,63,1574,4584,735,6893,Mid Murray (DC)
44340,1679,249,1962,10232,4541,648,15421,34114,2387,51922,Mitcham (C)
44550,389,60,454,5545,2082,379,8006,14257,991,23254,Mount Barker (DC)
44620,444,79,526,4197,1866,251,6314,12555,1129,19998,Mount Gambier (C)
44830,62,12,74,391,163,23,577,1618,201,2396,Mount Remarkable (DC)
45040,327,77,407,2839,1199,152,4190,10195,1570,15955,Murray Bridge (RC)
45090,166,36,205,1382,518,58,1958,4112,426,6496,Naracoorte and Lucindale (DC)
45120,121,6,127,699,292,33,1024,2460,184,3668,Northern Areas (DC)
45290,1116,155,1282,4720,2143,228,7091,21094,1844,30029,Norwood Payneham St Peters (C)
45340,2263,530,2820,26736,11716,1653,40105,81322,7040,128467,Onkaparinga (C)
45400,30,9,39,120,48,0,168,530,50,748,Orroroo/Carrieton (DC)
45540,32,11,43,218,92,8,318,978,130,1426,Peterborough (DC)
45890,2220,562,2799,16584,6494,712,23790,61698,7925,93413,Port Adelaide Enfield (C)
46090,113,71,187,1897,930,128,2955,6517,1673,11145,Port Augusta (C)
46300,280,65,345,2278,970,138,3386,7029,803,11218,Port Lincoln (C)
46450,368,56,427,2586,1099,146,3831,9070,966,13867,Port Pirie City and Dists (M)
46510,424,60,484,3250,1017,128,4395,11226,960,16581,Prospect (C)
46670,115,70,188,1344,498,59,1901,4876,707,7484,Renmark Paringa (DC)
46860,19,0,22,204,88,17,309,768,90,1167,Robe (DC)
46970,3,0,3,1011,139,47,1197,1955,475,3627,Roxby Downs (M)
47140,1400,339,1750,20989,8147,955,30091,66110,7271,103472,Salisbury (C)
47290,62,13,75,339,118,23,480,1119,97,1696,Southern Mallee (DC)
47490,47,9,56,315,96,25,436,1091,148,1675,Streaky Bay (DC)
47630,153,14,167,1142,361,57,1560,3366,217,5143,Tatiara (DC)
47700,1356,292,1664,15501,7445,863,23809,50801,3665,78275,Tea Tree Gully (C)
47800,83,24,107,867,385,38,1290,2776,406,4472,The Coorong (DC)
47980,1199,297,1512,5648,2335,285,8268,20776,1864,30908,Unley (C)
48050,534,150,684,1468,938,102,2508,8374,1125,12007,Victor Harbor (C)
48130,167,24,194,1026,426,66,1518,3400,373,5291,Wakefield (DC)
48640,36,9,45,239,69,18,326,595,46,967,Wudinna (DC)
48750,95,24,119,559,342,35,936,2588,221,3745,Yankalilla (DC)
48260,224,42,272,963,519,34,1516,4063,391,5970,Walkerville (M)
48340,195,51,249,1888,704,90,2682,6097,557,9336,Wattle Range (DC)
48410,1452,419,1885,7801,3250,310,11361,32367,3156,46884,West Torrens (C)
48540,241,66,307,3499,1395,161,5055,11119,1482,17656,Whyalla (C)
48830,293,40,337,1353,650,78,2081,6721,523,9325,Yorke Peninsula (DC)
49399,11,5,16,620,182,27,829,2235,589,3653,Unincorporated SA
49499,58,11,75,298,153,9,460,1845,461,2766,
50080,618,130,752,5414,1922,348,7684,17176,2061,26921,Albany (C)
50210,520,136,662,10345,3801,655,14801,30211,3916,48928,Armadale (C)
50250,3,0,3,1880,354,71,2305,4508,1402,8215,Ashburton (S)
51680,20,6,29,789,264,27,1080,2122,252,3454,Chittering (S)
51750,296,86,388,1245,571,61,1877,5256,690,7823,Claremont (T)
51820,736,196,942,16182,5084,774,22040,44276,4618,70934,Cockburn (C)
51890,122,21,143,1494,589,75,2158,4571,631,7360,Collie (S)
52100,29,6,35,153,71,11,235,577,61,873,Corrigin (S)
52170,126,70,196,1154,501,53,1708,3894,676,6278,Cottesloe (T)
52240,10,3,13,170,45,14,229,530,86,845,Cranbrook (S)
52310,6,0,6,163,38,9,210,440,38,688,Cuballing (S)
52380,5,0,5,18,3,3,24,144,58,226,Cue (S)
52450,20,9,29,185,60,9,254,736,67,1057,Cunderdin (S)
52520,11,6,17,204,80,13,297,667,53,1017,Dalwallinu (S)
52590,24,10,34,481,144,26,651,1614,307,2572,Dandaragan (S)
52660,163,35,201,2374,747,141,3262,5674,613,9549,Dardanup (S)
52730,82,20,102,820,246,81,1147,2791,258,4196,Denmark (S)
52800,24,8,32,973,504,115,1592,2758,2141,6491,Derby-West Kimberley (S)
52870,62,13,75,837,308,35,1180,2825,276,4281,Donnybrook-Balingup (S)
52940,15,9,24,122,47,7,176,315,29,520,Dowerin (S)
53010,7,0,7,111,39,12,162,300,23,485,Dumbleyung (S)
53080,6,3,9,155,41,11,207,550,170,927,Dundas (S)
53150,138,19,157,1230,472,67,1769,3484,377,5630,East Fremantle (T)
54280,125,36,161,5217,1340,315,6872,13648,3294,23814,Kalgoorlie/Boulder (C)
53710,14,3,17,178,58,5,241,469,46,756,Goomalling (S)
53780,784,261,1053,17810,6085,861,24756,51669,7565,83990,Gosnells (C)
53920,9,8,17,436,361,112,909,1393,188,2490,Halls Creek (S)
53990,162,38,200,4262,1363,235,5860,10606,1427,17893,Harvey (S)
54060,41,8,49,570,158,23,751,1834,226,2811,Irwin (S)
54130,5,0,5,196,61,10,267,489,58,814,Jerramungup (S)
54170,1560,395,1974,26475,10061,1469,38005,78508,6435,122948,Joondalup (C)
54200,603,157,771,8628,3761,519,12908,27140,2931,42979,Kalamunda (S)
54340,39,25,64,695,199,33,927,1976,258,3161,Katanning (S)
54480,0,0,0,117,31,0,148,233,9,390,Kent (S)
54550,34,3,37,354,150,17,521,947,91,1559,Kojonup (S)
54620,9,3,12,189,74,13,276,483,90,849,Kondinin (S)
54690,4,0,4,75,21,0,96,216,15,327,Koorda (S)
54760,13,0,13,168,56,11,235,365,21,621,Kulin (S)
54830,193,62,255,5151,1613,268,7032,12691,2803,22526,Kwinana (T)
54900,10,3,13,266,65,10,341,672,57,1070,Lake Grace (S)
54970,0,0,0,167,86,11,264,675,132,1071,Laverton (S)
56520,96,14,110,611,265,61,937,2054,244,3235,Narrogin (T)
56580,476,132,613,3497,1229,200,4926,10633,948,16507,Nedlands (C)
55040,6,0,9,337,84,16,437,1073,595,2105,Leonora (S)
55390,0,0,0,46,35,0,81,190,38,309,Menzies (S)
55530,3,0,3,90,14,3,107,233,22,362,Mingenew (S)
55670,12,3,15,146,44,18,208,409,51,668,Morawa (S)
55600,37,8,45,433,144,24,601,1201,125,1927,Moora (S)
65010,52,11,63,989,334,38,1361,3086,350,4797,Southern Midlands (M)
65210,31,8,39,336,155,14,505,1298,168,1971,Tasman (M)
56930,32,11,43,236,103,9,348,764,121,1233,Peppermint Grove (S)
55740,184,40,224,1271,482,50,1803,4748,569,7120,Mosman Park (T)
55810,0,0,0,55,16,4,75,368,75,518,Mount Magnet (S)
55880,3,0,3,86,17,9,112,251,7,370,Mount Marshall (S)
57140,22,4,26,171,79,10,260,579,70,909,Pingelly (S)
57210,75,13,88,785,212,32,1029,2535,360,3924,Plantagenet (S)
57280,23,7,30,2178,499,112,2789,6449,2600,11838,Port Hedland (T)
57630,0,0,0,7,0,0,7,68,17,92,Sandstone (S)
55950,3,0,3,67,35,8,110,266,25,401,Mukinbudin (S)
70200,65,47,115,3785,1351,273,5409,11740,2463,19612,Alice Springs (T)
56160,0,0,0,23,3,0,26,57,6,89,Murchison (S)
56230,137,47,184,2120,827,138,3085,7260,1006,11351,Murray (S)
56300,11,3,14,166,73,14,253,740,69,1062,Nannup (S)
62210,85,18,103,1002,422,49,1473,3403,366,5242,George Town (M)
62410,82,26,108,498,242,21,761,2576,254,3591,Glamorgan/Spring Bay (M)
62610,836,180,1026,6708,2964,363,10035,23677,2498,36210,Glenorchy (C)
62810,1018,256,1288,6741,2826,431,9998,28802,2746,41546,Hobart (C)
63010,170,29,199,2511,865,142,3518,7867,691,12076,Huon Valley (M)
63210,75,11,86,938,318,43,1299,3307,290,4896,Kentish (M)
63410,28,7,35,196,82,12,290,951,83,1324,King Island (M)
63610,469,128,609,5930,2486,393,8809,16743,1324,26876,Kingborough (M)
63810,168,26,194,1520,554,81,2155,5387,471,8013,Latrobe (M)
64010,1344,251,1602,9870,3746,468,14084,34693,3549,52326,Launceston (C)
64210,327,46,376,3052,1124,143,4319,10107,887,15313,Meander Valley (M)
64610,165,31,196,1918,682,101,2701,6563,619,9883,Northern Midlands (M)
64810,161,35,196,2231,812,144,3187,6682,717,10586,Sorell (M)
56370,15,11,29,120,47,7,174,440,46,660,Narembeen (S)
62010,13,3,16,98,41,6,145,476,45,666,Flinders (M)
56730,147,25,178,1511,594,97,2202,5165,899,8266,Northam (S)
57000,3,0,3,147,35,5,187,511,83,781,Perenjori (S)
57080,93,23,122,989,587,16,1592,11578,2685,15855,Perth (C)
58330,26,12,38,583,244,39,866,2397,335,3598,Toodyay (S)
72800,50,18,68,5203,1326,321,6850,11231,2194,20275,Palmerston (C)
74050,0,0,0,425,234,33,692,1078,64,1834,Tiwi Islands (S)
74500,8,0,11,1153,707,160,2020,1692,236,3948,Victoria-Daly (S)
58400,7,0,7,57,6,7,70,187,22,279,Trayning (S)
58470,0,0,0,40,11,0,51,104,28,183,Upper Gascoyne (S)
58540,6,3,9,175,37,6,218,429,46,693,Victoria Plains (S)
74560,0,0,0,47,26,0,73,219,35,327,Wagait (S)
74660,3,3,19,762,1138,672,2572,1544,308,4424,West Arnhem (S)
58570,518,80,606,4173,1366,217,5756,18849,2583,27188,Vincent (T)
99399,4,0,4,322,71,21,414,1211,884,2509,Unincorp. Other Territories
99499,0,0,0,3,0,0,3,18,0,21,
59030,3,0,3,50,9,0,59,151,18,228,Westonia (S)
59100,7,3,10,142,39,6,187,352,40,579,Wickepin (S)
59170,7,0,7,157,64,14,235,457,37,729,Williams (S)
59310,16,3,19,264,75,16,355,667,67,1089,Wongan-Ballidu (S)
59360,10,0,10,276,53,8,337,822,177,1336,Yilgarn (S)
59370,35,13,48,483,232,35,750,1796,229,2775,York (S)
59399,0,0,0,32,8,0,40,311,65,416,
59499,9,8,17,561,249,29,839,4552,1299,6690,
60210,111,26,140,828,260,22,1110,3623,432,5165,Break O'Day (M)
60410,108,18,126,2780,827,142,3749,6774,960,11483,Brighton (M)
60610,247,149,396,3023,1150,144,4317,9976,1181,15474,Burnie (C)
60810,329,112,441,3263,1361,169,4793,11229,1309,17331,Central Coast (M)
61010,20,3,23,318,104,7,429,1242,165,1836,Central Highlands (M)
61210,115,17,132,1396,491,74,1961,3790,418,6169,Circular Head (M)
61410,1041,161,1216,8275,3738,435,12448,26782,2894,42124,Clarence (C)
61510,121,19,140,1568,542,71,2181,5008,561,7750,Derwent Valley (M)
61610,516,147,663,3724,1519,232,5475,12813,1532,19820,Devonport (C)
61810,110,15,125,1039,395,36,1470,3654,362,5486,Dorset (M)
70420,19,0,22,992,589,86,1667,2467,827,4961,Barkly (S)
70540,0,0,0,10,41,0,51,67,10,128,Belyuen (S)
70620,13,3,24,535,429,144,1108,1187,352,2647,Central Desert (S)
70700,0,0,0,135,42,9,186,533,186,905,Coomalie (S)
71000,254,55,312,10239,3524,535,14298,36573,8154,59025,Darwin (C)
71300,16,0,16,1090,1846,558,3494,2434,306,6234,East Arnhem (S)
72200,23,4,27,1456,437,74,1967,4043,871,6881,Katherine (T)
72300,35,8,43,2955,961,148,4064,8746,2160,14970,Litchfield (M)
72330,11,4,15,784,495,131,1410,1825,1112,4347,MacDonnell (S)
