SA3_MAIN11,P_85ov_DNPCC,P_85ov_UCC_NS,P_85ov_Total,P_Tot_CF_Own_CCO,P_Tot_CF_Oth_CCO,P_Tot_CF_Own_CC_Oth_CC,P_Tot_CF_Total,P_Tot_DNPCC,P_Tot_UCC_NS,P_Tot_Total,SA3_NAME11
10801,829,366,1204,3604,1540,204,5348,17424,2411,25183,Great Lakes
10802,1129,212,1345,6018,2541,330,8889,25646,3498,38033,Kempsey - Nambucca
10803,7,0,7,52,15,0,67,223,14,304,Lord Howe Island
10804,1932,501,2455,10427,4251,615,15293,40006,4464,59763,Port Macquarie
10805,1156,230,1394,7000,2993,373,10366,28394,3150,41910,Taree - Gloucester
10901,1061,192,1268,9044,3594,461,13099,29613,3384,46096,Albury
10902,153,57,210,1854,709,82,2645,6362,915,9922,Lower Murray
10903,765,306,1087,5821,2404,267,8492,21648,2942,33082,Upper Murray exc. Albury
11001,570,124,697,5200,2034,279,7513,19166,2276,28955,Armidale
11002,688,207,901,5384,2086,294,7764,19900,2563,30227,Inverell - Tenterfield
11003,323,49,372,4045,1435,265,5745,12054,2011,19810,Moree - Narrabri
11004,1304,323,1646,11951,4684,586,17221,38500,5045,60766,Tamworth - Gunnedah
11101,2254,492,2776,18880,9426,963,29269,59892,5962,95123,Lake Macquarie - East
11102,1701,294,2004,10857,5390,594,16841,36605,3540,56986,Lake Macquarie - West
11103,3216,688,3950,23483,10836,1374,35693,84337,8962,128992,Newcastle
11201,1715,353,2087,11471,4289,753,16513,39044,4388,59945,Richmond Valley - Coastal
11202,1267,235,1519,10462,4401,677,15540,35934,3899,55373,Richmond Valley - Hinterland
11203,2252,633,2902,12421,4899,701,18021,45966,5958,69945,Tweed Valley
11301,698,183,895,7305,2761,313,10379,22209,3518,36106,Griffith - Murrumbidgee (West)
11302,286,63,353,2163,806,106,3075,7438,969,11482,Tumut - Tumbarumba
11303,1528,325,1876,13913,5534,717,20164,44969,5457,70590,Wagga Wagga
11401,2021,528,2567,12734,5528,681,18943,50318,6998,76259,Shoalhaven
11402,936,226,1168,6927,2851,351,10129,23198,2470,35797,Southern Highlands
11501,1841,430,2309,24379,8261,886,33526,68400,4537,106463,Baulkham Hills
11502,418,58,492,4149,1736,202,6087,13274,972,20333,Dural - Wisemans Ferry
11503,190,39,232,4152,1517,223,5892,11599,1493,18984,Hawkesbury
11504,128,26,154,5693,1615,227,7535,11485,1081,20101,Rouse Hill - McGraths Hill
11601,1323,270,1609,21213,6715,687,28615,63211,6813,98639,Blacktown
11602,280,34,321,15987,3562,585,20134,32366,3329,55829,Blacktown - North
11603,712,138,857,17389,5017,566,22972,47384,6681,77037,Mount Druitt
11701,566,98,676,6284,1882,182,8348,21186,2683,32217,Botany
11802,2316,432,2777,18348,6039,710,25097,73131,11258,109486,Eastern Suburbs - South
11901,2774,625,3443,24665,7726,640,33031,80728,10742,124501,Bankstown
11902,1542,452,2015,19985,5489,324,25798,63992,9735,99525,Canterbury
11903,2585,432,3047,18753,6196,469,25418,64345,6297,96060,Hurstville
69797,3,0,3,12,12,0,24,72,27,123,Migratory - Offshore - Shipping (Tas.)
20605,808,365,1188,10369,4164,427,14960,58505,7871,81336,Port Phillip
20903,461,155,627,11925,4137,752,16814,31460,2287,50561,Nillumbik - Kinglake
20904,1157,438,1602,28931,8646,867,38444,83846,9400,131690,Whittlesea - Wallan
21001,971,243,1229,8334,3614,236,12184,30390,3067,45641,Keilor
21002,255,47,308,5058,1628,266,6952,12654,1114,20720,Macedon Ranges
21003,1649,453,2122,9771,2946,286,13003,37188,5178,55369,Moreland - North
21004,274,125,405,6710,2354,308,9372,17922,1824,29118,Sunbury
21005,624,126,760,21741,5585,536,27862,65443,8562,101867,Tullamarine - Broadmeadows
21101,2089,417,2532,25015,8960,1192,35167,80499,6026,121692,Knox
21102,379,63,445,4429,1874,217,6520,13114,928,20562,Manningham - East
21103,1911,447,2374,17553,6441,958,24952,54600,4464,84016,Maroondah
21104,1078,305,1399,9447,3705,515,13667,30645,2427,46739,Whitehorse - East
11801,2253,664,2962,16808,6341,633,23782,65463,12906,102151,Eastern Suburbs - North
11904,2469,443,2949,18848,5994,423,25265,67414,8448,101127,Kogarah - Rockdale
12001,1207,281,1500,11991,3814,355,16160,40591,4800,61551,Canada Bay
12002,471,154,630,8883,2450,402,11735,28561,3119,43415,Leichhardt
12003,2446,570,3067,20182,5784,652,26618,79193,10068,115879,Strathfield - Burwood - Ashfield
12101,1950,294,2278,18266,4665,697,23628,52843,4797,81268,Chatswood - Lane Cove
12102,1209,236,1461,14608,4350,692,19650,38371,2862,60883,Hornsby
12103,2852,583,3485,19950,6753,800,27503,55037,4467,87007,Ku-ring-gai
12104,1520,355,1908,11836,4582,418,16836,52500,7165,76501,North Sydney - Mosman
12201,673,173,859,7000,2223,311,9534,20139,2558,32231,Manly
12202,1220,278,1518,10403,4011,555,14969,27891,2867,45727,Pittwater
12203,3251,588,3878,26055,8562,1199,35816,70027,6588,112431,Warringah
12301,613,82,704,10830,3213,515,14558,22817,1851,39226,Camden
12302,931,429,1378,23649,8932,923,33504,72396,9104,115004,Campbelltown (NSW)
12303,352,65,423,6494,2347,308,9149,17185,1798,28132,Wollondilly
12401,1209,322,1548,12550,5374,912,18836,38138,3954,60928,Blue Mountains
12402,0,0,0,0,0,0,0,6,0,6,Blue Mountains - South
12403,1119,282,1420,22351,8385,1077,31813,59079,6380,97272,Penrith
12404,499,77,585,6148,2330,304,8782,16953,2417,28152,Richmond - Windsor
12405,315,134,453,8469,3043,383,11895,25908,3070,40873,St Marys
12501,742,121,873,10979,2522,196,13697,38975,7115,59787,Auburn
12502,777,266,1056,10218,3278,355,13851,31348,3106,48305,Carlingford
12503,1789,450,2258,20655,6296,466,27417,69253,9803,106473,Merrylands - Guildford
12504,1780,489,2293,20895,5715,547,27157,65861,8792,101810,Parramatta
12601,855,101,975,7394,2621,289,10304,23681,1327,35312,Pennant Hills - Epping
12602,2681,491,3215,19303,5878,652,25833,67669,6163,99665,Ryde - Hunters Hill
12701,400,119,525,13274,3582,323,17179,38359,5534,61072,Bringelly - Green Valley
12702,1791,361,2189,24910,7954,486,33350,96249,10630,140229,Fairfield
12703,887,185,1082,17804,4669,515,22988,49992,7243,80223,Liverpool
12801,2299,511,2842,17037,7677,767,25481,54798,5402,85681,Cronulla - Miranda - Caringbah
12802,1462,281,1753,19293,7336,901,27530,52722,4086,84338,Sutherland - Menai - Heathcote
19797,0,0,0,6,0,0,6,89,15,110,Migratory - Offshore - Shipping (NSW)
19999,70,52,122,1113,551,42,1706,7210,2821,11737,Special Purpose Codes SA3 (NSW)
20101,1473,510,2006,15424,6484,877,22785,48349,5703,76837,Ballarat
20102,405,95,500,4118,1627,210,5955,14199,1674,21828,Creswick - Daylesford - Ballan
20103,462,106,576,3272,1347,170,4789,13310,1682,19781,Maryborough - Pyrenees
20201,1539,518,2068,13796,5738,790,20324,43833,4996,69153,Bendigo
20202,676,257,942,6678,2764,476,9918,22535,3102,35555,Heathcote - Castlemaine - Kyneton
20203,235,46,285,1568,694,79,2341,6080,738,9159,Loddon - Elmore
20301,184,24,211,3157,999,163,4319,7830,672,12821,Barwon - West
20302,3536,697,4268,27255,11585,1446,40286,90871,10251,141408,Geelong
20303,1248,268,1526,9984,4103,631,14718,30901,3268,48887,Surf Coast - Bellarine Peninsula
20401,872,187,1071,7295,2876,357,10528,26971,3307,40806,Upper Goulburn Valley
20402,959,292,1251,6485,2844,364,9693,23918,2454,36065,Wangaratta - Benalla
20403,1065,205,1279,10535,3995,606,15136,33545,3461,52142,Wodonga - Alpine
20501,635,210,852,7023,2784,370,10177,21778,2428,34383,Baw Baw
20502,895,207,1109,5675,2390,371,8436,23881,2709,35026,Gippsland - East
20503,1153,347,1512,8420,3704,450,12574,30454,3774,46802,Gippsland - South West
20504,1151,240,1400,11064,4688,583,16335,37127,4697,58159,Latrobe Valley
20505,691,166,867,6152,2570,375,9097,21021,3360,33478,Wellington
20601,1110,303,1427,10816,3616,550,14982,47267,5158,67407,Brunswick - Coburg
20602,803,129,938,7606,2390,485,10481,27370,2713,40564,Darebin - South
20603,1101,302,1426,9211,2728,373,12312,34112,4073,50497,Essendon
20604,630,159,795,6378,3224,208,9810,66423,10743,86976,Melbourne City
10101,1114,286,1409,10768,4114,526,15408,33958,4486,53852,Goulburn - Yass
10102,428,118,555,9288,3114,414,12816,26694,2979,42489,Queanbeyan
10103,346,55,408,2895,921,151,3967,9779,1547,15293,Snowy Mountains
10104,1524,388,1929,8954,3818,515,13287,38347,4734,56368,South Coast
10201,3901,1193,5128,25673,10860,1496,38029,83893,10683,132605,Gosford
10202,2941,858,3831,23866,9716,1282,34864,74558,9460,118882,Wyong
10301,630,94,730,6894,2844,379,10117,21246,3168,34531,Bathurst
10302,1194,231,1445,8108,3229,407,11744,27942,3707,43393,Lachlan Valley
10303,710,167,880,6564,2498,332,9394,22660,3287,35341,Lithgow - Mudgee
10304,849,136,992,9114,3369,467,12950,26263,3109,42322,Orange
10401,1034,204,1246,6845,3006,391,10242,26683,3171,40096,Clarence Valley
10402,1563,457,2028,12501,4767,710,17978,42962,4785,65725,Coffs Harbour
10501,275,55,333,3581,1261,162,5004,12386,2214,19604,Bourke - Cobar - Coonamble
10502,368,136,507,2953,1253,121,4327,11073,1922,17322,Broken Hill and Far West
10503,1111,204,1332,10479,4337,583,15399,32457,4538,52394,Dubbo
10601,1119,174,1301,13924,5789,725,20438,38935,5147,64520,Lower Hunter
10602,871,155,1032,11752,4582,609,16943,30060,3153,50156,Maitland
10603,1144,325,1475,10273,4626,599,15498,34727,4282,54507,Port Stephens
10604,381,75,459,5138,1736,236,7110,13797,2134,23041,Upper Hunter
10701,1207,260,1479,11368,5322,598,17288,36259,4164,57711,Dapto - Port Kembla
10702,0,0,0,3,0,0,3,0,3,6,Illawarra Catchment Reserve
10703,1309,212,1534,13947,6311,840,21098,41405,3960,66463,Kiama - Shellharbour
10704,2342,419,2786,18934,8589,1066,28589,63854,6609,99052,Wollongong
21105,1504,440,1963,25063,9462,1484,36009,72255,6800,115064,Yarra Ranges
21201,720,120,848,14301,4135,750,19186,34179,3595,56960,Cardinia
21202,1319,214,1548,22110,6324,809,29243,61711,6131,97085,Casey - North
21203,753,209,966,25132,6160,896,32188,58271,6243,96702,Casey - South
21204,2543,421,2994,23832,7721,515,32068,95454,11628,139150,Dandenong
21205,2987,752,3787,24044,9414,732,34190,94643,8316,137149,Monash
21301,1590,421,2030,25748,8131,498,34377,93197,13405,140979,Brimbank
21302,1236,330,1582,12920,4108,510,17538,42385,5048,64971,Hobsons Bay
21303,933,199,1147,10796,2841,415,14052,39614,6102,59768,Maribyrnong
21304,744,138,900,24608,6170,857,31635,55234,7310,94179,Melton - Bacchus Marsh
21305,898,221,1133,32476,7847,1018,41341,75908,9696,126945,Wyndham
21401,1678,602,2293,20783,7839,1127,29749,64571,7825,102145,Frankston
21402,3072,1101,4196,22706,9789,1272,33767,74854,9437,118058,Mornington Peninsula
21501,1405,374,1790,8744,3527,480,12751,31632,4013,48396,Grampians
21502,933,180,1118,7890,3039,387,11316,25470,3497,40283,Mildura
21503,857,206,1071,5416,2200,286,7902,19353,2671,29926,Murray River - Swan Hill
21601,710,193,908,5719,2350,242,8311,18588,2358,29257,Campaspe
30201,642,116,764,6380,2596,283,9259,19866,1494,30619,Bald Hills - Everton Park
30202,1427,476,1917,10436,3831,539,14806,35360,3848,54014,Chermside
11702,534,101,641,7131,2305,315,9751,29664,3781,43196,Marrickville - Sydenham - Petersham
11703,1027,428,1473,13307,5765,467,19539,119270,23142,161951,Sydney Inner City
30203,604,110,720,5066,1806,242,7114,19826,2011,28951,Nundah
20902,1624,497,2140,12491,4055,408,16954,49776,6935,73665,Darebin - North
30204,761,442,1210,8654,3208,438,12300,27133,3455,42888,Sandgate
30303,950,317,1275,10205,4005,439,14649,36131,3415,54195,Mt Gravatt
30305,492,117,613,9576,2963,334,12873,26595,2767,42235,Rocklea - Acacia Ridge
30306,503,130,642,7106,2519,258,9883,25620,2350,37853,Sunnybank
30401,506,55,570,5922,2045,287,8254,16320,1025,25599,Centenary
30402,523,269,804,8167,2693,468,11328,21386,1609,34323,Kenmore - Brookfield - Moggill
30403,660,215,885,6081,2429,306,8816,29082,2680,40578,Sherwood - Indooroopilly
30404,830,197,1037,8461,2988,466,11915,24073,1767,37755,The Gap - Enoggera
30501,603,261,869,4508,2392,185,7085,39202,6991,53278,Brisbane Inner
30502,338,91,435,6146,1776,278,8200,20586,2223,31009,Brisbane Inner - East
30503,992,176,1192,10978,3758,488,15224,44418,4004,63646,Brisbane Inner - North
30504,514,107,639,7971,2667,461,11099,31066,2575,44740,Brisbane Inner - West
30601,248,107,358,8658,2383,511,11552,22674,2649,36875,Cairns - North
30602,897,242,1158,14575,4961,746,20282,45136,8437,73855,Cairns - South
30603,451,81,538,4893,2002,236,7131,17193,2280,26604,Innisfail - Cassowary Coast
30604,85,22,107,1565,544,104,2213,5477,1082,8772,Port Douglas - Daintree
30605,482,224,712,5532,2133,340,8005,19502,2905,30412,Tablelands (East) - Kuranda
30701,495,102,600,7283,2176,333,9792,20310,3214,33316,Darling Downs (West) - Maranoa
30702,608,134,748,6480,2245,303,9028,19273,2996,31297,Darling Downs - East
30703,714,161,878,5920,2034,279,8233,20173,2151,30557,Granite Belt
30801,71,42,116,5738,1347,268,7353,12501,2402,22256,Central Highlands (Qld)
30802,504,97,604,13179,3676,674,17529,33225,4963,55717,Gladstone - Biloela
30803,1176,619,1809,17200,6262,943,24405,52923,9164,86492,Rockhampton
30901,1044,403,1452,7731,3208,283,11222,32721,5593,49536,Broadbeach - Burleigh
30902,970,300,1276,7403,2958,348,10709,27309,3671,41689,Coolangatta
30903,1117,529,1655,8107,3156,329,11592,33824,5034,50450,Gold Coast - North
30904,165,26,195,2861,1040,177,4078,8833,850,13761,Gold Coast Hinterland
20606,949,213,1182,5244,2737,182,8163,35604,4720,48487,Stonnington - West
20607,745,161,912,8261,3498,385,12144,47956,5844,65944,Yarra
20701,3828,744,4631,25900,8796,1076,35772,88136,7507,131415,Boroondara
20702,1621,476,2114,13069,5930,362,19361,49272,3880,72513,Manningham - West
20703,2151,694,2887,14998,5019,644,20661,52960,5403,79024,Whitehorse - West
20801,2717,537,3307,16273,5723,814,22810,46142,4864,73816,Bayside
21602,618,175,799,4012,1637,210,5859,14778,2050,22687,Moira
21603,1016,232,1262,9572,3366,427,13365,29852,4111,47328,Shepparton
21701,813,144,968,5503,2080,278,7861,19374,2060,29295,Glenelg - Southern Grampians
21702,1574,491,2083,13662,5514,750,19926,42545,5201,67672,Warrnambool - Otway Ranges
29797,0,0,0,13,0,0,13,24,3,40,Migratory - Offshore - Shipping (Vic.)
29999,39,15,54,830,373,24,1227,4418,1624,7269,Special Purpose Codes SA3 (Vic.)
30101,830,204,1041,12223,4666,651,17540,35142,2957,55639,Capalaba
30102,1443,284,1736,12743,4866,631,18240,39268,3769,61277,Cleveland - Stradbroke
30103,1044,180,1237,12069,4072,668,16809,31330,3065,51204,Wynnum - Manly
20802,3395,752,4207,22982,7008,964,30954,74847,7358,113159,Glen Eira
20803,2421,530,2988,18626,6140,850,25616,57450,6091,89157,Kingston
20804,757,206,978,6254,2112,238,8604,21856,2019,32479,Stonnington - East
20901,2400,479,2909,19131,7591,905,27627,63936,5668,97231,Banyule
30301,835,132,977,7970,2738,371,11079,25006,1986,38071,Carindale
30302,868,258,1132,9364,3200,513,13077,37849,4016,54942,Holland Park - Yeronga
30905,227,34,267,6250,1697,336,8283,14019,1417,23719,Mudgeeraba - Tallebudgera
30906,662,202,873,11474,3361,613,15448,30016,3711,49175,Nerang
30907,625,132,768,19123,5057,930,25110,41220,4582,70912,Ormeau - Oxenford
40401,2535,681,3242,14774,6622,587,21983,58064,5911,85958,Charles Sturt
40402,1184,235,1425,8097,3349,375,11821,31557,3696,47074,Port Adelaide - West
40403,1513,433,1965,8176,3488,338,12002,34046,3309,49357,West Torrens
40501,647,106,756,5623,2197,320,8140,17012,1449,26601,Barossa
30908,596,307,909,7250,2295,295,9840,23841,3272,36953,Robina
30909,906,417,1329,7635,2751,298,10684,30261,4903,45848,Southport
30910,574,163,742,3806,1662,144,5612,21350,4254,31216,Surfers Paradise
31001,584,307,902,10553,3289,431,14273,29129,6128,49530,Forest Lake - Oxley
31002,626,159,796,8882,3295,477,12654,28040,4099,44793,Ipswich Hinterland
31003,1151,267,1438,16018,6080,887,22985,45373,5263,73621,Ipswich Inner
31004,191,48,249,13253,3881,694,17828,27573,3185,48586,Springfield - Redbank
31101,235,34,272,1941,735,114,2790,6109,825,9724,Beaudesert
31403,245,140,388,6236,2378,335,8949,17287,1638,27874,Strathpine
31501,96,23,126,4620,2157,343,7120,11878,3009,22007,Far North
31502,116,31,150,5187,1682,293,7162,14231,3827,25220,Outback - North
31503,224,44,271,3098,935,120,4153,10061,1325,15539,Outback - South
31601,1042,200,1253,7973,2481,446,10900,23660,1949,36509,Buderim
31602,1526,437,1983,11206,4158,613,15977,37027,3958,56962,Caloundra
31603,886,190,1085,7468,2981,401,10850,28632,3345,42827,Maroochy
31604,886,153,1044,9833,3321,542,13696,29467,2944,46107,Nambour - Pomona
31605,733,233,966,5668,1881,257,7806,19360,2242,29408,Noosa
31606,539,153,695,7712,2751,434,10897,23441,2685,37023,Sunshine Coast Hinterland
31701,1946,793,2757,22792,8430,1308,32530,69159,8402,110091,Toowoomba
31801,766,128,901,6586,2561,315,9462,21944,2815,34221,Charters Towers - Ayr - Ingham
31802,1499,339,1855,28479,10068,1437,39984,85487,12223,137694,Townsville
31901,1377,418,1801,12448,4434,633,17515,44998,5772,68285,Bundaberg
31902,654,228,890,7042,2444,412,9898,24369,3179,37446,Burnett
31903,505,296,807,6920,2317,360,9597,23470,3240,36307,Gympie - Cooloola
31904,896,320,1219,7559,2499,388,10446,28750,3510,42706,Hervey Bay
30304,659,119,784,5744,1926,278,7948,19823,2289,30060,Nathan
31905,579,269,851,5962,2220,308,8490,22488,3452,34430,Maryborough
39797,6,3,9,33,24,0,57,301,94,452,Migratory - Offshore - Shipping (Qld)
39999,41,11,52,913,637,48,1598,7975,1912,11485,Special Purpose Codes SA3 (Qld)
40502,516,98,620,3283,1387,190,4860,11825,1136,17821,Lower North
40503,615,95,713,4008,1693,209,5910,14622,1530,22062,Mid North
40504,575,94,677,3123,1491,178,4792,14095,1201,20088,Yorke Peninsula
40601,840,216,1059,8986,3624,512,13122,28262,3505,44889,Eyre Peninsula and South West
40602,186,78,271,4228,1709,316,6253,13234,2967,22454,Outback - North and East
40701,1204,271,1487,6215,3323,361,9899,26438,2743,39080,Fleurieu - Kangaroo Island
40702,1069,232,1304,10626,4191,545,15362,31801,3103,50266,Limestone Coast
40703,1181,329,1528,9793,4106,526,14425,35683,4887,54995,Murray and Mallee
31401,430,130,560,16532,5212,886,22630,36471,2586,61687,Hills District
31402,544,155,705,10678,2930,532,14140,22567,2116,38823,North Lakes
40101,312,49,364,1250,846,45,2141,14202,2152,18495,Adelaide City
40102,855,151,1021,12335,4859,837,18031,33509,2474,54014,Adelaide Hills
50603,1467,463,1946,13003,4867,516,18386,50059,5365,73810,Canning
60302,199,31,233,2915,1060,172,4147,9412,831,14390,Huon - Bruny Island
60303,108,33,144,825,395,39,1259,3859,419,5537,South East Coast
60401,754,304,1067,7326,2939,352,10617,25248,2919,38784,Burnie - Ulverstone
60402,773,187,963,6630,2567,374,9571,22914,2425,34910,Devonport
60403,181,38,222,2980,986,146,4112,9096,983,14191,West Coast
69999,3,3,9,110,53,9,172,654,148,974,Special Purpose Codes SA3 (Tas.)
70101,81,9,90,2662,900,110,3672,13003,2865,19540,Darwin City
70102,173,48,228,7675,2670,424,10769,23937,6091,40797,Darwin Suburbs
70103,37,6,43,2904,926,151,3981,8558,2120,14659,Litchfield
31102,357,83,443,6180,2261,362,8803,18139,2543,29485,Beenleigh
31103,412,129,547,13003,4237,684,17924,32703,4083,54710,Browns Plains
31104,118,22,145,7690,2266,388,10344,15677,1715,27736,Jimboomba
31105,428,213,644,9506,3568,493,13567,26404,3068,43039,Loganlea - Carbrook
31106,565,149,729,12074,4746,569,17389,36074,4981,58444,Springwood - Kingston
31201,202,59,264,6398,1391,353,8142,15554,3620,27316,Bowen Basin - North
31202,1047,222,1281,19495,6408,973,26876,54010,7951,88837,Mackay
31203,124,19,146,2790,839,154,3783,9380,1938,15101,Whitsunday
31301,692,152,847,3588,1825,232,5645,18076,2194,25915,Bribie - Beachmere
31302,574,284,866,10161,3368,665,14194,26381,4256,44831,Caboolture
31303,114,18,132,1692,630,108,2430,5401,1246,9077,Caboolture Hinterland
31304,448,137,591,10752,3695,627,15074,26351,3124,44549,Narangba - Burpengary
31305,1293,259,1564,8080,3608,450,12138,30498,3555,46191,Redcliffe
40107,1199,297,1512,5647,2337,285,8269,20776,1863,30908,Unley
40201,444,94,541,5374,2055,295,7724,16040,1512,25276,Gawler - Two Wells
40202,859,189,1052,13199,4715,728,18642,38247,4666,61555,Playford
40203,1063,328,1405,9243,3524,376,13143,32612,4409,50164,Port Adelaide - East
40204,1324,313,1648,20805,8065,947,29817,65344,7137,102298,Salisbury
40205,1338,291,1642,14870,7138,827,22835,48676,3539,75050,Tea Tree Gully
49797,0,0,0,0,0,0,0,6,0,6,Migratory - Offshore - Shipping (SA)
49999,58,12,76,297,154,9,460,1845,461,2766,Special Purpose Codes SA3 (SA)
50101,640,130,773,7484,2335,427,10246,20247,2542,33035,Augusta - Margaret River - Busselton
50102,1052,267,1335,16226,5471,886,22583,45305,6263,74151,Bunbury
50103,280,61,344,3474,1167,183,4824,11309,1083,17216,Manjimup
50201,1222,500,1731,12267,5020,716,18003,43265,6232,67500,Mandurah
50301,1423,398,1842,10120,3962,523,14605,34119,3696,52420,Cottesloe - Claremont
50302,1413,337,1766,11714,4192,574,16480,55329,8280,80089,Perth City
50401,1375,236,1625,11159,4283,546,15988,43130,4749,63867,Bayswater - Bassendean
50402,416,111,540,6332,2712,419,9463,19529,3702,32694,Mundaring
50403,711,204,923,18885,5446,845,25176,48289,6240,79705,Swan
50501,1561,397,1977,26479,10063,1469,38011,78518,6437,122966,Joondalup
50502,3042,805,3891,26623,10437,1110,38170,97224,12424,147818,Stirling
50503,1103,329,1444,29893,7973,1389,39255,67471,8253,114979,Wanneroo
40304,2267,531,2826,26990,11829,1661,40480,81906,7059,129445,Onkaparinga
50704,2063,480,2561,15065,6138,822,22025,54835,4848,81708,Melville
50705,962,251,1225,18969,6130,1075,26174,48051,6193,80418,Rockingham
50801,156,46,202,2647,771,137,3555,7433,1151,12139,Esperance
50802,52,14,66,1379,419,82,1880,4475,938,7293,Gascoyne
50803,143,46,195,6792,1957,437,9186,18306,4764,32256,Goldfields
50804,78,31,109,4789,2074,536,7399,14201,4645,26245,Kimberley
50805,496,134,637,8547,2906,498,11951,26213,4042,42206,Mid West
50806,43,11,54,9356,2121,532,12009,25850,10518,48377,Pilbara
50901,892,196,1094,9062,3032,569,12663,27886,3331,43880,Albany
50902,620,149,778,8223,2841,435,11499,27175,3689,42363,Wheat Belt - North
50903,303,62,365,3475,1211,229,4915,10098,1373,16386,Wheat Belt - South
59797,0,0,0,32,7,0,39,311,66,416,Migratory - Offshore - Shipping (WA)
59999,8,8,19,561,253,28,842,4551,1299,6692,Special Purpose Codes SA3 (WA)
60101,114,16,133,2860,870,150,3880,7091,972,11943,Brighton
60102,1022,161,1192,7924,3573,411,11908,25625,2794,40327,Hobart - North East
60103,940,197,1148,7738,3346,401,11485,27145,2873,41503,Hobart - North West
60104,444,121,575,5525,2286,364,8175,15196,1180,24551,Hobart - South and West
60105,1020,255,1284,6752,2834,430,10016,28870,2750,41636,Hobart Inner
60106,174,38,215,2500,936,162,3598,7525,800,11923,Sorell - Dodges Ferry
60201,1626,353,1988,12393,4726,600,17719,42449,4072,64240,Launceston
60202,304,53,360,3448,1212,179,4839,11841,1161,17841,Meander Valley - West Tamar
60203,502,93,601,5546,2010,235,7791,19738,2060,29589,North East
60301,85,14,102,1836,594,67,2497,5827,696,9020,Central Highlands (Tas.)
40103,1206,329,1558,6361,2889,315,9565,23851,2076,35492,Burnside
40104,1122,187,1326,7404,3369,271,11044,27215,2138,40397,Campbelltown (SA)
40105,1115,156,1285,4723,2143,227,7093,21095,1843,30031,Norwood - Payneham - St Peters
40303,1673,248,1954,9980,4429,637,15046,33532,2367,50945,Mitcham
40106,652,107,763,4215,1537,162,5914,15288,1347,22549,Prospect - Walkerville
40301,1395,260,1666,4089,2449,217,6755,20141,2027,28923,Holdfast Bay
40302,2008,443,2466,12608,5539,661,18808,47684,4187,70679,Marion
50601,521,135,662,10345,3801,655,14801,30210,3916,48927,Armadale
50602,897,212,1118,8741,2947,346,12034,36635,5401,54070,Belmont - Victoria Park
50604,784,260,1052,17810,6085,861,24756,51669,7565,83990,Gosnells
50605,602,158,770,8628,3761,518,12907,27140,2929,42976,Kalamunda
50606,108,20,128,3363,1082,163,4608,7976,1034,13618,Serpentine - Jarrahdale
50607,884,213,1106,5159,2204,303,7666,24488,2793,34947,South Perth
50701,722,192,923,15833,4959,747,21539,42967,4544,69050,Cockburn
50702,646,112,762,4848,2113,337,7298,18847,2223,28368,Fremantle
50703,193,62,255,5151,1613,268,7032,12692,2803,22527,Kwinana
70104,49,19,68,5185,1323,320,6828,11196,2188,20212,Palmerston
70202,14,3,17,743,459,86,1288,2226,703,4217,Barkly
70203,11,3,26,2390,2036,866,5292,5136,866,11294,Daly - Tiwi - West Arnhem
70204,17,0,17,2262,2026,616,4904,4224,618,9746,East Arnhem
70205,35,9,52,2650,1489,353,4492,6739,1531,12762,Katherine
79797,0,0,0,3,0,0,3,91,16,110,Migratory - Offshore - Shipping (NT)
79999,0,0,0,127,79,0,206,1254,264,1724,Special Purpose Codes SA3 (NT)
70201,92,53,153,5335,2337,510,8182,15385,4175,27742,Alice Springs
80101,864,261,1136,14811,6197,811,21819,48845,4727,75391,Belconnen
80102,0,3,3,98,25,6,129,279,26,434,Cotter - Namadgi
80103,5,0,8,131,60,6,197,721,429,1347,Fyshwick - Pialligo - Hume
80104,101,14,118,9930,2175,417,12522,21592,1550,35664,Gungahlin
80105,689,184,890,5561,2129,375,8065,30692,3315,42072,North Canberra
80106,685,80,774,3347,1318,136,4801,14397,1380,20578,South Canberra
80107,473,83,567,15035,5494,853,21382,44666,3038,69086,Tuggeranong
80108,421,49,470,3811,1721,216,5748,11883,745,18376,Weston Creek
80109,749,99,858,5091,2048,234,7373,18652,1331,27356,Woden
89797,0,0,0,0,0,0,0,0,0,0,Migratory - Offshore - Shipping (ACT)
89999,3,3,6,63,36,3,102,404,68,574,Special Purpose Codes SA3 (ACT)
90101,0,0,0,205,28,0,233,736,835,1804,Christmas Island
90102,4,0,4,75,16,9,100,290,29,419,Cocos (Keeling) Islands
90103,0,0,0,45,27,7,79,180,21,280,Jervis Bay
99797,0,0,0,0,3,0,3,3,0,6,Migratory - Offshore - Shipping (OT)
99999,0,0,0,0,3,0,3,18,0,21,Special Purpose Codes SA3 (OT)
