SA4_MAIN11,P_85ov_DNPCC,P_85ov_UCC_NS,P_85ov_Total,P_Tot_CF_Own_CCO,P_Tot_CF_Oth_CCO,P_Tot_CF_Own_CC_Oth_CC,P_Tot_CF_Total,P_Tot_DNPCC,P_Tot_UCC_NS,P_Tot_Total,SA4_NAME11
101,3413,845,4296,31902,11972,1607,45481,108779,13746,168006,Capital Region
102,6846,2055,8966,49535,20576,2779,72890,158455,20142,251487,Central Coast
103,3385,623,4044,30683,11939,1582,44204,98109,13272,155585,Central West
104,2598,662,3279,19348,7772,1102,28222,69646,7955,105823,Coffs Harbour - Grafton
105,1757,391,2168,17014,6849,866,24729,55919,8673,89321,Far West and Orana
106,3514,727,4266,41089,16730,2171,59990,117520,14714,192224,Hunter Valley exc Newcastle
107,4860,892,5799,44247,20223,2506,66976,141519,14738,223233,Illawarra
108,5056,1310,6404,27095,11340,1526,39961,111693,13539,165193,Mid North Coast
109,1980,557,2566,16720,6707,811,24238,57622,7240,89100,Murray
110,2881,708,3623,26579,10239,1424,38242,89623,11897,139762,New England and North West
111,7170,1473,8729,53216,25653,2932,81801,180832,18463,281096,Newcastle and Lake Macquarie
112,5233,1224,6509,34359,13584,2134,50077,120940,14247,185264,Richmond - Tweed
113,2509,570,3124,23380,9103,1134,33617,74617,9946,118180,Riverina
114,2959,755,3737,19660,8381,1029,29070,73516,9466,112052,Southern Highlands and Shoalhaven
115,2579,552,3189,38380,13129,1536,53045,104763,8076,165884,Sydney - Baulkham Hills and Hawkesbury
116,2316,443,2793,54588,15294,1839,71721,142961,16821,231503,Sydney - Blacktown
117,2121,626,2783,26718,9955,966,37639,170117,29606,237362,Sydney - City and Inner South
118,4567,1095,5735,35158,12380,1338,48876,138590,24165,211631,Sydney - Eastern Suburbs
119,9371,1951,11459,82255,25402,1856,109513,276474,35222,421209,Sydney - Inner South West
120,4121,1003,5196,41055,12050,1403,54508,148341,17990,220839,Sydney - Inner West
121,7532,1469,9133,64662,20351,2603,87616,198754,19293,305663,Sydney - North Sydney and Hornsby
122,5146,1036,6253,43463,14795,2067,60325,118055,12014,190394,Sydney - Northern Beaches
123,1899,579,2505,40973,14494,1744,57211,112396,12755,182362,Sydney - Outer South West
124,3138,817,4005,49521,19129,2676,71326,140084,15825,227235,Sydney - Outer West and Blue Mountains
125,5083,1331,6478,62747,17813,1563,82123,205441,28813,316377,Sydney - Parramatta
126,3538,590,4190,26699,8497,940,36136,91350,7489,134975,Sydney - Ryde
127,3079,661,3789,55985,16196,1332,73513,184603,23405,281521,Sydney - South West
128,3760,791,4598,36328,15016,1672,53016,107520,9486,170022,Sydney - Sutherland
197,0,0,0,6,0,0,6,89,15,110,Migratory - Offshore - Shipping (NSW)
199,70,51,121,1111,552,43,1706,7210,2821,11737,Special Purpose Codes SA4 (NSW)
201,2338,711,3079,22810,9461,1260,33531,75855,9063,118449,Ballarat
202,2449,820,3296,22041,9202,1344,32587,72448,8834,113869,Bendigo
203,4968,990,6003,40395,16685,2242,59322,129609,14192,203123,Geelong
204,2893,684,3603,24320,9715,1326,35361,84438,9216,129015,Hume
205,4524,1173,5736,38334,16129,2155,56618,134254,16971,207843,Latrobe - Gippsland
206,6149,1630,7871,57890,22357,2610,82857,317235,41119,441211,Melbourne - Inner
207,7602,1915,9632,53969,19741,2082,75792,190369,16797,282958,Melbourne - Inner East
208,9293,2026,11480,64135,20980,2867,87982,200291,20334,308607,Melbourne - Inner South
209,5642,1568,7282,72483,24428,2933,99844,229018,24289,353151,Melbourne - North East
210,3778,994,4826,51615,16125,1633,69373,163596,19744,252713,Melbourne - North West
211,6961,1676,8718,81504,30444,4366,116314,251118,20644,388076,Melbourne - Outer East
212,8319,1712,10142,109417,33757,3696,146870,344255,35914,527039,Melbourne - South East
213,5403,1314,6797,106548,29095,3298,138941,306339,41560,486840,Melbourne - West
214,4748,1704,6487,43492,17628,2395,63515,139428,17261,220204,Mornington Peninsula
215,3195,755,3977,22048,8768,1149,31965,76457,10181,118603,North West
216,2339,599,2963,19297,7358,884,27539,63217,8517,99273,Shepparton
217,2389,633,3047,19161,7593,1029,27783,61919,7262,96964,Warrnambool and South West
297,0,0,0,9,0,0,9,24,3,36,Migratory - Offshore - Shipping (Vic.)
299,39,15,54,831,372,24,1227,4418,1624,7269,Special Purpose Codes SA4 (Vic.)
301,3319,666,4013,37032,13605,1953,52590,105742,9789,168121,Brisbane - East
302,3438,1139,4613,30539,11442,1505,43486,102179,10808,156473,Brisbane - North
303,4309,1066,5421,49959,17362,2193,69514,171019,16822,257355,Brisbane - South
304,2513,742,3294,28634,10156,1523,40313,90858,7086,138257,Brisbane - West
305,2449,636,3137,29607,10590,1407,41604,135276,15792,192672,Brisbane Inner City
306,2168,677,2872,35222,12024,1938,49184,109981,17356,176521,Cairns
307,1815,398,2229,19686,6457,909,27052,59756,8358,95166,Darling Downs - Maranoa
308,1750,760,2529,36120,11284,1886,49290,98651,16527,164468,Fitzroy
309,6883,2511,9464,81646,27186,3748,112580,263394,37286,413260,Gold Coast
310,2553,778,3381,48704,16543,2486,67733,130116,18678,216527,Ipswich
311,2116,629,2776,50393,17809,2615,70817,135112,17214,223143,Logan - Beaudesert
312,1373,301,1691,28684,8640,1479,38803,78943,13510,131256,Mackay
313,3118,850,4000,34272,13132,2082,49486,106709,14369,170564,Moreton Bay - North
314,1216,426,1653,33444,10518,1755,45717,76325,6336,128378,Moreton Bay - South
315,437,98,549,12901,4777,755,18433,36173,8164,62770,Queensland - Outback
316,5612,1368,7029,49855,17570,2697,70122,161585,17127,248834,Sunshine Coast
317,1947,793,2758,22793,8428,1309,32530,69159,8402,110091,Toowoomba
318,2262,469,2755,35064,12627,1757,49448,107431,15035,171914,Townsville
319,4012,1530,5571,39930,13911,2102,55943,144070,19155,219168,Wide Bay
397,6,3,9,32,23,3,58,302,93,453,Migratory - Offshore - Shipping (Qld)
399,41,11,52,912,637,50,1599,7974,1912,11485,Special Purpose Codes SA4 (Qld)
401,6465,1277,7831,41936,17981,2134,62051,155940,13891,231882,Adelaide - Central and Hills
402,5024,1216,6287,63491,25503,3171,92165,200916,21263,314344,Adelaide - North
403,7345,1482,8918,53673,24245,3179,81097,183266,15634,279997,Adelaide - South
404,5233,1347,6628,31045,13461,1299,45805,123665,12917,182387,Adelaide - West
405,2350,400,2771,16032,6765,900,23697,57555,5317,86569,Barossa - Yorke - Mid North
406,1022,293,1324,13217,5331,831,19379,41494,6473,67346,South Australia - Outback
407,3456,829,4321,26630,11621,1431,39682,93924,10736,144342,South Australia - South East
497,0,0,0,0,0,0,0,6,0,6,Migratory - Offshore - Shipping (SA)
499,59,11,76,299,153,8,460,1843,462,2765,Special Purpose Codes SA4 (SA)
501,1972,461,2453,27185,8974,1492,37651,76861,9886,124398,Bunbury
502,1223,500,1732,12267,5020,716,18003,43266,6232,67501,Mandurah
503,2837,736,3611,21833,8154,1097,31084,89453,11974,132511,Perth - Inner
504,2502,552,3089,36373,12445,1809,50627,110950,14693,176270,Perth - North East
505,5711,1525,7309,82992,28471,3975,115438,243218,27113,385769,Perth - North West
506,5260,1463,6780,67050,24748,3364,95162,228168,29000,352330,Perth - South East
507,4588,1099,5732,59865,20957,3245,84067,177396,20613,282076,Perth - South West
508,966,279,1257,33511,10244,2224,45979,96475,26060,168514,Western Australia - Outback
509,1810,407,2237,20763,7082,1231,29076,65158,8395,102629,Western Australia - Wheat Belt
597,0,0,0,32,7,0,39,308,67,414,Migratory - Offshore - Shipping (WA)
599,9,8,17,561,249,29,839,4552,1299,6690,Special Purpose Codes SA4 (WA)
601,3714,790,4552,33301,13848,1920,49069,111441,11376,171886,Hobart
602,2438,502,2956,21389,7950,1012,30351,74023,7295,111669,Launceston and North East
603,398,82,480,5581,2048,276,7905,19094,1951,28950,South East
604,1714,533,2258,16942,6495,873,24310,57257,6323,87890,West and North West
697,0,0,0,6,9,0,15,85,12,112,Migratory - Offshore - Shipping (Tas.)
699,0,0,0,111,58,3,172,654,149,975,Special Purpose Codes SA4 (Tas.)
701,339,80,426,18426,5816,1001,25243,56696,13270,95209,Darwin
702,168,68,267,13380,8352,2430,24162,33708,7890,65760,Northern Territory - Outback
797,0,0,0,6,0,0,6,91,13,110,Migratory - Offshore - Shipping (NT)
799,0,0,0,127,79,0,206,1254,264,1724,Special Purpose Codes SA4 (NT)
801,3988,773,4828,57812,21173,3055,82040,191724,16540,290304,Australian Capital Territory
897,0,0,0,3,0,0,3,0,0,3,Migratory - Offshore - Shipping (ACT)
899,6,0,6,62,37,3,102,404,65,571,Special Purpose Codes SA4 (ACT)
901,4,0,4,324,71,18,413,1207,883,2503,Other Territories
997,0,0,0,0,0,0,0,3,0,3,Migratory - Offshore - Shipping (OT)
999,0,0,0,0,3,0,3,21,0,24,Special Purpose Codes SA4 (OT)
