SA4_MAIN11,Intct_fam_no_otr_chld_pre_Fam,Step_fam_no_otr_chld_pre_Fam,Blnd_fam_no_otr_chld_pre_Fam,Intct_fam_othr_child_pres_Fam,Step_fam_othr_child_pres_Fam,Blnd_fam_othr_child_pres_Fam,Otr_cpl_fam_otr_chld_only_Fam,Tot_Families,SA4_NAME11
101,19027,1747,1153,171,10,37,157,22302,Capital Region
102,29424,2969,1944,299,34,40,231,34941,Central Coast
103,18026,1526,1125,189,17,44,182,21109,Central West
104,10779,1058,738,139,5,29,100,12848,Coffs Harbour - Grafton
105,9553,753,605,168,18,24,172,11293,Far West and Orana
106,24161,2248,1685,257,31,40,213,28635,Hunter Valley exc Newcastle
107,29104,2333,1424,268,21,47,176,33373,Illawarra
108,15236,1485,1022,194,15,32,204,18188,Mid North Coast
109,9863,776,573,81,3,14,103,11413,Murray
110,15474,1298,954,191,14,34,181,18146,New England and North West
111,32639,2994,1807,330,27,66,238,38101,Newcastle and Lake Macquarie
112,19067,1842,1177,209,13,30,157,22495,Richmond - Tweed
113,14375,1099,820,121,10,19,134,16578,Riverina
114,11480,1018,712,112,5,28,118,13473,Southern Highlands and Shoalhaven
115,31247,1596,898,303,6,20,82,34152,Sydney - Baulkham Hills and Hawkesbury
116,38612,2297,1598,668,47,51,177,43450,Sydney - Blacktown
117,16236,1055,340,160,6,11,63,17871,Sydney - City and Inner South
118,23014,1283,465,125,6,5,51,24949,Sydney - Eastern Suburbs
119,64284,3224,1531,854,33,59,175,70160,Sydney - Inner South West
120,29112,1471,518,260,8,17,62,31448,Sydney - Inner West
121,46326,2222,789,271,4,22,94,49728,Sydney - North Sydney and Hornsby
122,29293,1818,808,187,9,16,41,32172,Sydney - Northern Beaches
123,27787,2195,1580,427,33,58,180,32260,Sydney - Outer South West
124,32119,2809,1847,370,37,59,201,37442,Sydney - Outer West and Blue Mountains
125,47797,2291,1079,666,18,42,153,52046,Sydney - Parramatta
126,20652,930,330,202,9,17,37,22177,Sydney - Ryde
127,46433,2489,1454,835,45,61,178,51495,Sydney - South West
128,26877,1665,829,153,5,20,59,29608,Sydney - Sutherland
197,0,0,0,0,0,0,0,0,Migratory - Offshore - Shipping (NSW)
199,0,0,0,0,0,0,0,0,Special Purpose Codes SA4 (NSW)
201,13398,1144,714,110,10,15,75,15466,Ballarat
202,13092,1156,719,88,6,20,61,15142,Bendigo
203,25448,2007,1119,148,5,30,89,28846,Geelong
204,14612,1318,798,85,10,13,91,16927,Hume
205,22724,2098,1404,170,21,19,181,26617,Latrobe - Gippsland
206,36991,2235,680,182,10,26,79,40203,Melbourne - Inner
207,42147,2006,743,338,3,18,72,45327,Melbourne - Inner East
208,45137,2539,994,206,9,19,59,48963,Melbourne - Inner South
209,54421,3110,1618,423,9,36,136,59753,Melbourne - North East
210,39435,2238,1238,370,8,26,94,43409,Melbourne - North West
211,58694,4350,2209,388,18,54,146,65859,Melbourne - Outer East
212,80104,5298,3014,1112,49,80,248,89905,Melbourne - South East
213,73052,4709,2564,916,42,90,267,81640,Melbourne - West
214,26337,2730,1499,176,14,30,104,30890,Mornington Peninsula
215,13335,1023,758,99,10,23,104,15352,North West
216,11768,959,633,92,13,12,85,13562,Shepparton
217,11600,837,607,85,3,7,71,13210,Warrnambool and South West
297,0,0,0,0,0,0,0,0,Migratory - Offshore - Shipping (Vic.)
299,0,0,0,0,0,0,0,0,Special Purpose Codes SA4 (Vic.)
301,23508,2289,1252,197,15,35,83,27379,Brisbane - East
302,19254,1687,798,184,11,12,73,22019,Brisbane - North
303,33752,2270,1111,410,12,40,108,37703,Brisbane - South
304,20219,1308,561,105,3,10,34,22240,Brisbane - West
305,17764,1247,452,86,4,11,49,19613,Brisbane Inner City
306,19505,1808,1201,299,22,42,178,23055,Cairns
307,11365,870,742,129,5,13,116,13240,Darling Downs - Maranoa
308,20727,1988,1456,241,20,42,159,24633,Fitzroy
309,47622,4779,2688,392,37,72,219,55809,Gold Coast
310,27964,2880,2062,437,39,72,201,33655,Ipswich
311,29757,3293,2387,522,52,64,234,36309,Logan - Beaudesert
312,16949,1536,1124,154,24,25,96,19908,Mackay
313,19156,2331,1694,205,22,44,132,23584,Moreton Bay - North
314,20761,1851,1192,137,12,24,76,24053,Moreton Bay - South
315,6748,561,493,354,33,48,146,8383,Queensland - Outback
316,28393,2858,1577,182,13,22,129,33174,Sunshine Coast
317,13358,1107,804,133,10,15,92,15519,Toowoomba
318,20451,2019,1427,281,35,49,178,24440,Townsville
319,21956,2282,1712,239,32,44,217,26482,Wide Bay
397,0,0,0,0,0,0,0,0,Migratory - Offshore - Shipping (Qld)
399,0,0,0,0,0,0,0,0,Special Purpose Codes SA4 (Qld)
401,28837,1940,851,157,9,9,75,31878,Adelaide - Central and Hills
402,38902,3938,2237,441,38,77,211,45844,Adelaide - North
403,34661,3253,1720,210,15,29,134,40022,Adelaide - South
404,20455,1622,722,155,9,23,103,23089,Adelaide - West
405,9515,866,554,92,7,7,79,11120,Barossa - Yorke - Mid North
406,7170,679,489,115,16,31,103,8603,South Australia - Outback
407,15237,1374,979,122,12,17,142,17883,South Australia - South East
497,0,0,0,0,0,0,0,0,Migratory - Offshore - Shipping (SA)
499,0,0,0,0,0,0,0,0,Special Purpose Codes SA4 (SA)
501,15502,1399,995,125,9,15,102,18147,Bunbury
502,6940,821,533,61,10,19,68,8452,Mandurah
503,14789,878,286,52,0,5,36,16046,Perth - Inner
504,23400,2082,1152,268,16,36,126,27080,Perth - North East
505,55912,4090,2341,535,34,59,184,63155,Perth - North West
506,44070,3841,2047,581,27,80,233,50879,Perth - South East
507,38596,3342,1954,331,23,68,186,44500,Perth - South West
508,17324,1552,1173,445,61,89,279,20923,Western Australia - Outback
509,11747,958,712,115,12,20,140,13704,Western Australia - Wheat Belt
597,0,0,0,0,0,0,0,0,Migratory - Offshore - Shipping (WA)
599,0,0,0,0,0,0,0,0,Special Purpose Codes SA4 (WA)
601,19276,2166,1257,153,13,25,142,23032,Hobart
602,12321,1300,874,65,6,17,94,14677,Launceston and North East
603,3202,353,190,35,6,7,29,3822,South East
604,9533,1179,774,84,3,18,97,11688,West and North West
697,0,0,0,0,0,0,0,0,Migratory - Offshore - Shipping (Tas.)
699,0,0,0,0,0,0,0,0,Special Purpose Codes SA4 (Tas.)
701,10868,1201,736,171,12,35,81,13104,Darwin
702,7000,557,416,692,106,91,278,9140,Northern Territory - Outback
797,0,0,0,0,0,0,0,0,Migratory - Offshore - Shipping (NT)
799,0,0,0,0,0,0,0,0,Special Purpose Codes SA4 (NT)
801,38009,3063,1583,345,25,42,129,43196,Australian Capital Territory
897,0,0,0,0,0,0,0,0,Migratory - Offshore - Shipping (ACT)
899,0,0,0,0,0,0,0,0,Special Purpose Codes SA4 (ACT)
901,261,11,9,6,0,0,7,294,Other Territories
997,0,0,0,0,0,0,0,0,Migratory - Offshore - Shipping (OT)
999,0,0,0,0,0,0,0,0,Special Purpose Codes SA4 (OT)
